Country,Confirmed,Deaths,Recovered,Active,New cases,New deaths,New recovered,Deaths / 100 Cases,Recovered / 100 Cases,Deaths / 100 Recovered,Confirmed last week,1 week change,1 week % increase,WHO Region
Afghanistan,205506,7833,0,197673,115,0,0,3.81,0.0,inf,204982,524,0.26,Eastern Mediterranean
Albania,333305,3594,0,329711,12,0,0,1.08,0.0,inf,333233,72,0.02,Europe
Algeria,271050,6881,0,264169,9,0,0,2.54,0.0,inf,270996,54,0.02,Africa
Andorra,46824,156,0,46668,0,0,0,0.33,0.0,inf,46824,0,0.0,Europe
Angola,104491,1923,0,102568,0,0,0,1.84,0.0,inf,103131,1360,1.32,Africa
Anguilla (UK),3904,12,0,3892,0,0,0,0.31,0.0,inf,3904,0,0.0,Americas
Antarctica,11,0,0,11,0,0,0,0.0,0.0,0.0,11,0,0.0,
Antigua and Barbuda,9106,146,0,8960,0,0,0,1.6,0.0,inf,9106,0,0.0,Americas
Argentina,9723924,130017,0,9593907,0,0,0,1.34,0.0,inf,9721718,2206,0.02,Americas
Armenia,445631,8709,0,436922,0,0,0,1.95,0.0,inf,445513,118,0.03,Europe
Aruba (NL),43568,236,0,43332,0,0,0,0.54,0.0,inf,43494,74,0.17,Americas
Australia,10627363,16075,0,10611288,55575,49,0,0.15,0.0,inf,10553237,74126,0.7,Western Pacific
Austria,5535259,21165,0,5514094,4803,6,0,0.38,0.0,inf,5506697,28562,0.52,Europe
Azerbaijan,824127,9975,0,814152,45,0,0,1.21,0.0,inf,823849,278,0.03,Europe
Bahamas,37471,833,0,36638,10,0,0,2.22,0.0,inf,37439,32,0.09,Americas
Bahrain,695584,1535,0,694049,136,0,0,0.22,0.0,inf,694464,1120,0.16,Eastern Mediterranean
Bangladesh,2036469,29431,0,2007038,20,0,0,1.45,0.0,inf,2036306,163,0.01,South-East Asia
Barbados,103955,564,0,103391,0,0,0,0.54,0.0,inf,103545,410,0.4,Americas
Belarus,994037,7118,0,986919,0,0,0,0.72,0.0,inf,994037,0,0.0,Europe
Belgium,4633112,33042,0,4600070,3560,15,0,0.71,0.0,inf,4627186,5926,0.13,Europe
Belize,69012,688,0,68324,0,0,0,1.0,0.0,inf,68988,24,0.03,Americas
Benin,27922,163,0,27759,0,0,0,0.58,0.0,inf,27922,0,0.0,Africa
Bhutan,62488,21,0,62467,0,0,0,0.03,0.0,inf,62460,28,0.04,South-East Asia
Bolivia,1110413,22244,0,1088169,0,0,0,2.0,0.0,inf,1110014,399,0.04,Americas
Bosnia and Herzegovina,400448,16199,0,384249,18,1,0,4.05,0.0,inf,400322,126,0.03,Europe
Botswana,326344,2790,0,323554,0,0,0,0.85,0.0,inf,326344,0,0.0,Africa
Brazil,35105241,689342,0,34415899,23205,70,0,1.96,0.0,inf,34971043,134198,0.38,Americas
British Virgin Islands (UK),7305,64,0,7241,0,0,0,0.88,0.0,inf,7305,0,0.0,Americas
Brunei,253406,225,0,253181,0,0,0,0.09,0.0,inf,248861,4545,1.83,Western Pacific
Bulgaria,1286305,38022,0,1248283,198,2,0,2.96,0.0,inf,1284838,1467,0.11,Europe
Burkina Faso,21631,387,0,21244,0,0,0,1.79,0.0,inf,21631,0,0.0,Africa
Burma,633118,19488,0,613630,22,0,0,3.08,0.0,inf,632910,208,0.03,South-East Asia
Burundi,50778,38,0,50740,0,0,0,0.07,0.0,inf,50639,139,0.27,Africa
Cabo Verde,62892,412,0,62480,30,0,0,0.66,0.0,inf,62758,134,0.21,Africa
Cambodia,138046,3056,0,134990,7,0,0,2.21,0.0,inf,138010,36,0.03,Western Pacific
Cameroon,123993,1965,0,122028,0,0,0,1.58,0.0,inf,123993,0,0.0,Africa
Canada,4427229,47849,0,4379380,1672,67,0,1.08,0.0,inf,4417344,9885,0.22,Americas
Cayman Islands (UK),31194,36,0,31158,0,0,0,0.12,0.0,inf,31194,0,0.0,Americas
Central African Republic,15311,113,0,15198,0,0,0,0.74,0.0,inf,15289,22,0.14,Africa
Chad,7641,194,0,7447,0,0,0,2.54,0.0,inf,7637,4,0.05,Africa
Chile,4895292,62288,0,4833004,6106,57,0,1.27,0.0,inf,4859241,36051,0.74,Americas
China,3449676,15885,0,3433791,12568,13,0,0.46,0.0,inf,3210359,239317,7.45,Western Pacific
Colombia,6312657,141881,0,6170776,0,0,0,2.25,0.0,inf,6312657,0,0.0,Americas
Comoros,8941,161,0,8780,0,0,0,1.8,0.0,inf,8925,16,0.18,Africa
Congo (Brazzaville),25375,386,0,24989,0,0,0,1.52,0.0,inf,25375,0,0.0,Africa
Congo (Kinshasa),93837,1452,0,92385,0,0,0,1.55,0.0,inf,93467,370,0.4,Africa
Costa Rica,1143597,9031,0,1134566,0,0,0,0.79,0.0,inf,1140864,2733,0.24,Americas
Cote d'Ivoire,87883,830,0,87053,1,0,0,0.94,0.0,inf,87864,19,0.02,Africa
Croatia,1252367,17282,0,1235085,331,4,0,1.38,0.0,inf,1250968,1399,0.11,Europe
Cuba,1111360,8530,0,1102830,6,0,0,0.77,0.0,inf,1111333,27,0.0,Americas
Curacao (NL),45559,295,0,45264,0,0,0,0.65,0.0,inf,45536,23,0.05,Americas
Cyprus,610023,1218,0,608805,0,0,0,0.2,0.0,inf,606287,3736,0.62,Europe
Czechia,4170021,41783,0,4128238,528,9,0,1.0,0.0,inf,4167299,2722,0.07,Europe
Denmark,3348972,7508,0,3341464,714,8,0,0.22,0.0,inf,3345095,3877,0.12,Europe
Djibouti,15690,189,0,15501,0,0,0,1.2,0.0,inf,15690,0,0.0,Eastern Mediterranean
Dominica,15760,74,0,15686,0,0,0,0.47,0.0,inf,15760,0,0.0,Americas
Dominican Republic,648456,4384,0,644072,0,0,0,0.68,0.0,inf,647868,588,0.09,Americas
Ecuador,1009958,35940,0,974018,0,0,0,3.56,0.0,inf,1009388,570,0.06,Americas
Egypt,515645,24798,0,490847,0,0,0,4.81,0.0,inf,515645,0,0.0,Eastern Mediterranean
El Salvador,201785,4230,0,197555,0,0,0,2.1,0.0,inf,201785,0,0.0,Americas
Equatorial Guinea,17182,183,0,16999,0,0,0,1.07,0.0,inf,17182,0,0.0,Africa
Eritrea,10189,103,0,10086,0,0,0,1.01,0.0,inf,10189,0,0.0,Africa
Estonia,608796,2757,0,606039,0,0,0,0.45,0.0,inf,608332,464,0.08,Europe
Eswatini,73770,1422,0,72348,0,0,0,1.93,0.0,inf,73708,62,0.08,Africa
Ethiopia,494428,7572,0,486856,56,0,0,1.53,0.0,inf,494270,158,0.03,Africa
Falkland Islands (Malvinas) (UK),1930,0,0,1930,0,0,0,0.0,0.0,0.0,1930,0,0.0,Africa
Faroe Islands (DK),34658,28,0,34630,0,0,0,0.08,0.0,inf,34658,0,0.0,Europe
Fiji,68375,878,0,67497,68,0,0,1.28,0.0,inf,68307,68,0.1,Western Pacific
Finland,1394254,7265,0,1386989,9600,92,0,0.52,0.0,inf,1384654,9600,0.69,Europe
France,36625360,155411,0,36469949,50530,60,0,0.42,0.0,inf,36356078,269282,0.74,Europe
French Guiana,94729,411,0,94318,0,0,0,0.43,0.0,inf,94421,308,0.33,Americas
French Polynesia,76827,649,0,76178,0,0,0,0.84,0.0,inf,76827,0,0.0,Western Pacific
Gabon,48972,306,0,48666,0,0,0,0.62,0.0,inf,48959,13,0.03,Africa
Gambia,12586,372,0,12214,0,0,0,2.96,0.0,inf,12580,6,0.05,Africa
Georgia,1805698,16912,0,1788786,0,0,0,0.94,0.0,inf,1785138,20560,1.15,Europe
Germany,36348477,157388,0,36191089,30016,274,0,0.43,0.0,inf,36180077,168400,0.47,Europe
Ghana,171009,1461,0,169548,13,0,0,0.85,0.0,inf,170972,37,0.02,Africa
Gibraltar (UK),20184,110,0,20074,0,0,0,0.54,0.0,inf,20166,18,0.09,Europe
Greece,5360506,34178,0,5326328,0,0,0,0.64,0.0,inf,5306482,54024,1.02,Europe
Greenland (DK),11971,21,0,11950,0,0,0,0.18,0.0,inf,11971,0,0.0,Europe
Grenada,19616,237,0,19379,0,0,0,1.21,0.0,inf,19616,0,0.0,Americas
Guadeloupe (FR),197105,993,0,196112,0,0,0,0.5,0.0,inf,197105,0,0.0,Americas
Guatemala,1151582,19943,0,1131639,1182,1,0,1.73,0.0,inf,1147070,4512,0.39,Americas
Guinea,38153,464,0,37689,0,0,0,1.22,0.0,inf,38153,0,0.0,Africa
Guinea-Bissau,8848,176,0,8672,0,0,0,1.99,0.0,inf,8848,0,0.0,Africa
Guyana,71560,1284,0,70276,2,0,0,1.79,0.0,inf,71520,40,0.06,Americas
Haiti,33846,860,0,32986,9,0,0,2.54,0.0,inf,33837,9,0.03,Americas
Holy See,29,0,0,29,0,0,0,0.0,0.0,0.0,29,0,0.0,Europe
Honduras,457676,11043,0,446633,0,0,0,2.41,0.0,inf,457459,217,0.05,Americas
Hungary,2162093,48245,0,2113848,0,0,0,2.23,0.0,inf,2157995,4098,0.19,Europe
Iceland,206803,219,0,206584,0,0,0,0.11,0.0,inf,206803,0,0.0,Europe
India,44672048,530604,0,44141444,340,3,0,1.19,0.0,inf,44667967,4081,0.01,South-East Asia
Indonesia,6634648,159565,0,6475083,7110,41,0,2.41,0.0,inf,6590113,44535,0.68,South-East Asia
Iran,7559467,144633,0,7414834,21,1,0,1.91,0.0,inf,7559164,303,0.0,Eastern Mediterranean
Iraq,2463021,25363,0,2437658,0,0,0,1.03,0.0,inf,2462317,704,0.03,Eastern Mediterranean
Ireland,1678827,8170,0,1670657,0,0,0,0.49,0.0,inf,1677386,1441,0.09,Europe
Israel,4711855,11823,0,4700032,2059,0,0,0.25,0.0,inf,4701936,9919,0.21,Europe
Italy,24031538,180518,0,23851020,0,0,0,0.75,0.0,inf,23823192,208346,0.87,Europe
Jamaica,152517,3399,0,149118,0,0,0,2.23,0.0,inf,152381,136,0.09,Americas
Japan,24151056,48780,0,24102276,60108,130,0,0.2,0.0,inf,23540544,610512,2.59,Western Pacific
Jordan,1746997,14122,0,1732875,0,0,0,0.81,0.0,inf,1746997,0,0.0,Eastern Mediterranean
Kazakhstan,1485635,19053,0,1466582,0,0,0,1.28,0.0,inf,1485635,0,0.0,Europe
Kenya,341319,5684,0,335635,84,0,0,1.67,0.0,inf,340784,535,0.16,Africa
Kiribati,3430,13,0,3417,0,0,0,0.38,0.0,inf,3430,0,0.0,Western Pacific
"Korea, North",1,6,0,-5,0,0,0,600.0,0.0,inf,1,0,0.0,
Kosovo,272204,3202,0,269002,1,0,0,1.18,0.0,inf,272195,9,0.0,Europe
Kuwait,662617,2569,0,660048,0,0,0,0.39,0.0,inf,662510,107,0.02,Eastern Mediterranean
Kyrgyzstan,206511,2991,0,203520,0,0,0,1.45,0.0,inf,206483,28,0.01,Europe
Laos,216568,758,0,215810,14,0,0,0.35,0.0,inf,216444,124,0.06,Western Pacific
Latvia,961627,6086,0,955541,541,1,0,0.63,0.0,inf,959019,2608,0.27,Europe
Lebanon,1220272,10732,0,1209540,61,1,0,0.88,0.0,inf,1219834,438,0.04,Eastern Mediterranean
Lesotho,34490,706,0,33784,0,0,0,2.05,0.0,inf,34490,0,0.0,Africa
Liberia,8014,294,0,7720,0,0,0,3.67,0.0,inf,8014,0,0.0,Africa
Libya,507078,6437,0,500641,0,0,0,1.27,0.0,inf,507070,8,0.0,Eastern Mediterranean
Liechtenstein,20859,87,0,20772,0,0,0,0.42,0.0,inf,20798,61,0.29,Europe
Lithuania,1274185,9424,0,1264761,299,2,0,0.74,0.0,inf,1272547,1638,0.13,Europe
Luxembourg,305929,1158,0,304771,235,1,0,0.38,0.0,inf,304770,1159,0.38,Europe
Madagascar,67054,1411,0,65643,0,0,0,2.1,0.0,inf,66859,195,0.29,Africa
Malawi,88073,2685,0,85388,0,0,0,3.05,0.0,inf,88073,0,0.0,Africa
Malaysia,4978350,36636,0,4941714,2877,8,0,0.74,0.0,inf,4960179,18171,0.37,Western Pacific
Maldives,185584,311,0,185273,0,0,0,0.17,0.0,inf,185549,35,0.02,South-East Asia
Mali,32757,742,0,32015,1,0,0,2.27,0.0,inf,32750,7,0.02,Africa
Malta,115750,809,0,114941,16,0,0,0.7,0.0,inf,115660,90,0.08,Europe
Marshall Islands,15501,17,0,15484,0,0,0,0.11,0.0,inf,15389,112,0.73,Western Pacific
Martinique (FR),223877,1057,0,222820,0,0,0,0.47,0.0,inf,223877,0,0.0,Americas
Mauritania,63419,997,0,62422,0,0,0,1.57,0.0,inf,63414,5,0.01,Africa
Mauritius,271867,1034,0,270833,0,0,0,0.38,0.0,inf,268397,3470,1.29,Africa
Mayotte (FR),40612,187,0,40425,0,0,0,0.46,0.0,inf,40612,0,0.0,Africa
Mexico,7125176,330495,0,6794681,0,0,0,4.64,0.0,inf,7118933,6243,0.09,Americas
Micronesia,22203,55,0,22148,0,0,0,0.25,0.0,inf,22203,0,0.0,Western Pacific
Moldova,594754,11913,0,582841,0,0,0,2.0,0.0,inf,594441,313,0.05,Europe
Monaco,15285,65,0,15220,24,0,0,0.43,0.0,inf,15165,120,0.79,Europe
Mongolia,991461,2134,0,989327,467,0,0,0.22,0.0,inf,988879,2582,0.26,Western Pacific
Montenegro,283586,2789,0,280797,20,0,0,0.98,0.0,inf,283443,143,0.05,Europe
Montserrat (UK),1403,8,0,1395,0,0,0,0.57,0.0,inf,1403,0,0.0,Americas
Morocco,1267966,16283,0,1251683,150,0,0,1.28,0.0,inf,1267039,927,0.07,Eastern Mediterranean
Mozambique,230590,2224,0,228366,0,0,0,0.96,0.0,inf,230543,47,0.02,Africa
Namibia,169946,4080,0,165866,0,0,0,2.4,0.0,inf,169946,0,0.0,Africa
Nauru,4621,1,0,4620,0,0,0,0.02,0.0,inf,4618,3,0.06,Western Pacific
Nepal,1000865,12019,0,988846,2,0,0,1.2,0.0,inf,1000838,27,0.0,South-East Asia
Netherlands,8536718,22901,0,8513817,0,0,0,0.27,0.0,inf,8531316,5402,0.06,Europe
New Zealand,1924563,2183,0,1922380,0,0,0,0.11,0.0,inf,1900511,24052,1.27,Western Pacific
Nicaragua,15232,245,0,14987,0,0,0,1.61,0.0,inf,15219,13,0.09,Americas
Niger,9430,314,0,9116,0,0,0,3.33,0.0,inf,9430,0,0.0,Africa
Nigeria,266283,3155,0,263128,0,0,0,1.18,0.0,inf,266242,41,0.02,Africa
North Macedonia,344710,9568,0,335142,0,0,0,2.78,0.0,inf,344531,179,0.05,Europe
Norway,1468135,4332,0,1463803,190,0,0,0.3,0.0,inf,1467160,975,0.07,Europe
Oman,399027,4628,0,394399,0,0,0,1.16,0.0,inf,399027,0,0.0,Eastern Mediterranean
Pakistan,1574965,30630,0,1544335,0,0,0,1.94,0.0,inf,1574825,140,0.01,Eastern Mediterranean
Palau,5684,7,0,5677,0,0,0,0.12,0.0,inf,5572,112,2.01,Western Pacific
Panama,995726,8519,0,987207,0,0,0,0.86,0.0,inf,992623,3103,0.31,Americas
Papua New Guinea,45819,668,0,45151,0,0,0,1.46,0.0,inf,45819,0,0.0,Western Pacific
Paraguay,718071,19611,0,698460,0,0,0,2.73,0.0,inf,718049,22,0.0,Americas
Peru,4209905,217314,0,3992591,12879,27,0,5.16,0.0,inf,4180834,29071,0.7,Americas
Philippines,4029201,64524,0,3964677,1014,20,0,1.6,0.0,inf,4022127,7074,0.18,Western Pacific
Poland,6350427,118296,0,6232131,454,4,0,1.86,0.0,inf,6348022,2405,0.04,Europe
Portugal,5537108,25395,0,5511713,0,0,0,0.46,0.0,inf,5532964,4144,0.07,Europe
Qatar,476976,684,0,476292,293,0,0,0.14,0.0,inf,475199,1777,0.37,Eastern Mediterranean
Reunion (FR),479430,902,0,478528,0,0,0,0.19,0.0,inf,478855,575,0.12,Africa
Romania,3294447,67253,0,3227194,0,0,0,2.04,0.0,inf,3293346,1101,0.03,Europe
Russia,21250733,383785,0,20866948,5742,57,0,1.81,0.0,inf,21214339,36394,0.17,Europe
Rwanda,132681,1467,0,131214,0,0,0,1.11,0.0,inf,132643,38,0.03,Africa
Saint Kitts and Nevis,6556,46,0,6510,2,0,0,0.7,0.0,inf,6552,4,0.06,Americas
Saint Lucia,29692,408,0,29284,0,0,0,1.37,0.0,inf,29692,0,0.0,Americas
Saint Pierre and Miquelon (FR),3248,1,0,3247,0,0,0,0.03,0.0,inf,3233,15,0.46,Americas
Saint Vincent and the Grenadines,9462,116,0,9346,0,0,0,1.23,0.0,inf,9462,0,0.0,Americas
Samoa,15967,29,0,15938,3,0,0,0.18,0.0,inf,15949,18,0.11,Western Pacific
San Marino,22091,119,0,21972,293,0,0,0.54,0.0,inf,21798,293,1.34,Europe
Sao Tome and Principe,6278,77,0,6201,0,0,0,1.23,0.0,inf,6275,3,0.05,Africa
Saudi Arabia,825332,9454,0,815878,42,3,0,1.15,0.0,inf,824917,415,0.05,Eastern Mediterranean
Senegal,88859,1968,0,86891,0,0,0,2.21,0.0,inf,88842,17,0.02,Africa
Serbia,2420189,17353,0,2402836,571,1,0,0.72,0.0,inf,2416113,4076,0.17,Europe
Seychelles,49862,298,0,49564,0,0,0,0.6,0.0,inf,49380,482,0.98,Africa
Sierra Leone,7758,126,0,7632,0,0,0,1.62,0.0,inf,7758,0,0.0,Africa
Singapore,2160324,1701,0,2158623,1615,0,0,0.08,0.0,inf,2148794,11530,0.54,Western Pacific
Sint Maarten (NL),10949,89,0,10860,0,0,0,0.81,0.0,inf,10943,6,0.05,Americas
Slovakia,2648927,20722,0,2628205,247,3,0,0.78,0.0,inf,2647741,1186,0.04,Europe
Slovenia,1251867,6923,0,1244944,1136,6,0,0.55,0.0,inf,1245626,6241,0.5,Europe
Solomon Islands,24575,153,0,24422,0,0,0,0.62,0.0,inf,21884,2691,12.3,Western Pacific
Somalia,27286,1361,0,25925,32,0,0,4.99,0.0,inf,27254,32,0.12,Eastern Mediterranean
South Africa,4039858,102395,0,3937463,514,0,0,2.53,0.0,inf,4036623,3235,0.08,Africa
South Korea,26837840,30278,0,26807562,53698,55,0,0.11,0.0,inf,26462319,375521,1.42,Western Pacific
South Sudan,18348,138,0,18210,0,0,0,0.75,0.0,inf,18339,9,0.05,Africa
Spain,13573721,115641,0,13458080,0,0,0,0.85,0.0,inf,13551539,22182,0.16,Europe
Sri Lanka,671610,16797,0,654813,24,1,0,2.5,0.0,inf,671481,129,0.02,South-East Asia
Sudan,63637,4990,0,58647,12,4,0,7.84,0.0,inf,63595,42,0.07,Eastern Mediterranean
Summer Olympics 2020,865,0,0,865,0,0,0,0.0,0.0,0.0,865,0,0.0,
Suriname,81228,1392,0,79836,0,0,0,1.71,0.0,inf,81228,0,0.0,Americas
Sweden,2626686,21034,0,2605652,3896,106,0,0.8,0.0,inf,2622790,3896,0.15,Europe
Switzerland,4318881,14116,0,4304765,0,0,0,0.33,0.0,inf,4297635,21246,0.49,Europe
Syria,57392,3163,0,54229,1,0,0,5.51,0.0,inf,57385,7,0.01,Eastern Mediterranean
Taiwan*,8226995,14125,0,8212870,16040,65,0,0.17,0.0,inf,8112234,114761,1.41,Western Pacific
Tajikistan,17786,125,0,17661,0,0,0,0.7,0.0,inf,17786,0,0.0,Europe
Tanzania,40471,845,0,39626,0,0,0,2.09,0.0,inf,40311,160,0.4,Africa
Thailand,4702330,33106,0,4669224,0,0,0,0.7,0.0,inf,4698373,3957,0.08,South-East Asia
Timor-Leste,23336,138,0,23198,1,0,0,0.59,0.0,inf,23320,16,0.07,South-East Asia
Togo,39326,290,0,39036,3,0,0,0.74,0.0,inf,39321,5,0.01,Africa
Tonga,16182,12,0,16170,0,0,0,0.07,0.0,inf,16182,0,0.0,Western Pacific
Trinidad and Tobago,185237,4266,0,180971,0,0,0,2.3,0.0,inf,185094,143,0.08,Americas
Tunisia,1146991,29268,0,1117723,0,0,0,2.55,0.0,inf,1146799,192,0.02,Eastern Mediterranean
Turkey,16919638,101203,0,16818435,0,0,0,0.6,0.0,inf,16919638,0,0.0,Europe
Turks and Caicos Islands (UK),6446,36,0,6410,0,0,0,0.56,0.0,inf,6431,15,0.23,Americas
Tuvalu,2828,0,0,2828,0,0,0,0.0,0.0,0.0,1555,1273,81.86,Western Pacific
US,98538245,1079052,0,97459193,34783,123,0,1.1,0.0,inf,98251350,286895,0.29,Americas
Uganda,169663,3630,0,166033,0,0,0,2.14,0.0,inf,169663,0,0.0,Africa
Ukraine,5642326,118400,0,5523926,42,1,0,2.1,0.0,inf,5635218,7108,0.13,Europe
United Arab Emirates,1043390,2348,0,1041042,224,0,0,0.23,0.0,inf,1041874,1516,0.15,Eastern Mediterranean
United Kingdom,24516381,212319,0,24304062,386918,499,0,0.87,0.0,inf,24129091,387290,1.61,Europe
Uruguay,992887,7530,0,985357,0,0,0,0.76,0.0,inf,992035,852,0.09,Americas
Uzbekistan,245763,1637,0,244126,98,0,0,0.67,0.0,inf,245177,586,0.24,Europe
Vanuatu,11981,14,0,11967,0,0,0,0.12,0.0,inf,11981,0,0.0,Western Pacific
Venezuela,547049,5827,0,541222,0,0,0,1.07,0.0,inf,546534,515,0.09,Americas
Vietnam,11513173,43170,0,11470003,489,1,0,0.37,0.0,inf,11510484,2689,0.02,Western Pacific
West Bank and Gaza,703036,5708,0,697328,0,0,0,0.81,0.0,inf,703036,0,0.0,Eastern Mediterranean
Winter Olympics 2022,535,0,0,535,0,0,0,0.0,0.0,0.0,535,0,0.0,
Yemen,11945,2159,0,9786,0,0,0,18.07,0.0,inf,11945,0,0.0,Eastern Mediterranean
Zambia,333721,4019,0,329702,0,0,0,1.2,0.0,inf,333685,36,0.01,Africa
Zimbabwe,257893,5606,0,252287,0,0,0,2.17,0.0,inf,257893,0,0.0,Africa
