Country,Confirmed,Deaths,Recovered,Active,New cases,New deaths,New recovered,Deaths / 100 Cases,Recovered / 100 Cases,Deaths / 100 Recovered,Confirmed last week,1 week change,1 week % increase,WHO Region
Afghanistan,209036,7896,0,201140,25,0,0,3.78,0.0,inf,208721,315,0.15,Eastern Mediterranean
Albania,334264,3596,0,330668,9,0,0,1.08,0.0,inf,334211,53,0.02,Europe
Algeria,271409,6881,0,264528,0,0,0,2.54,0.0,inf,271399,10,0.0,Africa
Andorra,47860,165,0,47695,0,0,0,0.34,0.0,inf,47850,10,0.02,Europe
Angola,105184,1931,0,103253,0,0,0,1.84,0.0,inf,105184,0,0.0,Africa
Anguilla (UK),3904,12,0,3892,0,0,0,0.31,0.0,inf,3904,0,0.0,Americas
Antarctica,11,0,0,11,0,0,0,0.0,0.0,0.0,11,0,0.0,
Antigua and Barbuda,9106,146,0,8960,0,0,0,1.6,0.0,inf,9106,0,0.0,Americas
Argentina,10042136,130448,0,9911688,0,0,0,1.3,0.0,inf,10040329,1807,0.02,Americas
Armenia,446332,8719,0,437613,0,0,0,1.95,0.0,inf,446008,324,0.07,Europe
Aruba (NL),44026,282,0,43744,0,0,0,0.64,0.0,inf,43993,33,0.08,Americas
Australia,11330342,19070,0,11311272,0,0,0,0.17,0.0,inf,11312904,17438,0.15,Western Pacific
Austria,5837337,21795,0,5815542,5218,6,0,0.37,0.0,inf,5807176,30161,0.52,Europe
Azerbaijan,828251,10099,0,818152,16,0,0,1.22,0.0,inf,828106,145,0.02,Europe
Bahamas,37491,833,0,36658,0,0,0,2.22,0.0,inf,37491,0,0.0,Americas
Bahrain,700835,1544,0,699291,0,0,0,0.22,0.0,inf,700835,0,0.0,Eastern Mediterranean
Bangladesh,2037703,29445,0,2008258,15,0,0,1.45,0.0,inf,2037622,81,0.0,South-East Asia
Barbados,106434,573,0,105861,0,0,0,0.54,0.0,inf,106434,0,0.0,Americas
Belarus,994037,7118,0,986919,0,0,0,0.72,0.0,inf,994037,0,0.0,Europe
Belgium,4700949,33616,0,4667333,0,0,0,0.72,0.0,inf,4695403,5546,0.12,Europe
Belize,70721,688,0,70033,0,0,0,0.97,0.0,inf,70697,24,0.03,Americas
Benin,27990,163,0,27827,0,0,0,0.58,0.0,inf,27989,1,0.0,Africa
Bhutan,62611,21,0,62590,0,0,0,0.03,0.0,inf,62608,3,0.0,South-East Asia
Bolivia,1191342,22355,0,1168987,170,0,0,1.88,0.0,inf,1189949,1393,0.12,Americas
Bosnia and Herzegovina,401499,16265,0,385234,27,4,0,4.05,0.0,inf,401444,55,0.01,Europe
Botswana,329595,2801,0,326794,0,0,0,0.85,0.0,inf,329494,101,0.03,Africa
Brazil,36953492,697762,0,36255730,0,0,0,1.89,0.0,inf,36887991,65501,0.18,Americas
British Virgin Islands (UK),7305,64,0,7241,0,0,0,0.88,0.0,inf,7305,0,0.0,Americas
Brunei,277441,225,0,277216,616,0,0,0.08,0.0,inf,276067,1374,0.5,Western Pacific
Bulgaria,1296009,38198,0,1257811,51,3,0,2.95,0.0,inf,1295701,308,0.02,Europe
Burkina Faso,22056,396,0,21660,0,0,0,1.8,0.0,inf,22025,31,0.14,Africa
Burma,633870,19490,0,614380,3,0,0,3.07,0.0,inf,633846,24,0.0,South-East Asia
Burundi,53574,38,0,53536,0,0,0,0.07,0.0,inf,53492,82,0.15,Africa
Cabo Verde,63237,413,0,62824,2,0,0,0.65,0.0,inf,63233,4,0.01,Africa
Cambodia,138705,3056,0,135649,0,0,0,2.2,0.0,inf,138698,7,0.01,Western Pacific
Cameroon,123993,1965,0,122028,0,0,0,1.58,0.0,inf,123993,0,0.0,Africa
Canada,4582517,50997,0,4531520,957,11,0,1.11,0.0,inf,4573984,8533,0.19,Americas
Cayman Islands (UK),31472,37,0,31435,0,0,0,0.12,0.0,inf,31472,0,0.0,Americas
Central African Republic,15368,113,0,15255,0,0,0,0.74,0.0,inf,15368,0,0.0,Africa
Chad,7661,194,0,7467,0,0,0,2.53,0.0,inf,7652,9,0.12,Africa
Chile,5140809,64015,0,5076794,1005,2,0,1.25,0.0,inf,5130204,10605,0.21,Americas
China,4903517,100922,0,4802595,0,0,0,2.06,0.0,inf,4903513,4,0.0,Western Pacific
Colombia,6355637,142276,0,6213361,0,0,0,2.24,0.0,inf,6355135,502,0.01,Americas
Comoros,8992,161,0,8831,0,0,0,1.79,0.0,inf,8992,0,0.0,Africa
Congo (Brazzaville),32818,743,0,32075,0,0,0,2.26,0.0,inf,32798,20,0.06,Africa
Congo (Kinshasa),95646,1464,0,94182,0,0,0,1.53,0.0,inf,95585,61,0.06,Africa
Costa Rica,1194584,9195,0,1185389,4207,14,0,0.77,0.0,inf,1190377,4207,0.35,Americas
Cote d'Ivoire,88078,834,0,87244,14,0,0,0.95,0.0,inf,88014,64,0.07,Africa
Croatia,1268287,17932,0,1250355,55,4,0,1.41,0.0,inf,1267962,325,0.03,Europe
Cuba,1112525,8530,0,1103995,2,0,0,0.77,0.0,inf,1112494,31,0.0,Americas
Curacao (NL),45986,301,0,45685,0,0,0,0.65,0.0,inf,45986,0,0.0,Americas
Cyprus,645515,1293,0,644222,0,0,0,0.2,0.0,inf,644160,1355,0.21,Europe
Czechia,4596830,42358,0,4554472,1404,10,0,0.92,0.0,inf,4592556,4274,0.09,Europe
Denmark,3401725,8209,0,3393516,155,3,0,0.24,0.0,inf,3400755,970,0.03,Europe
Djibouti,15690,189,0,15501,0,0,0,1.2,0.0,inf,15690,0,0.0,Eastern Mediterranean
Dominica,15760,74,0,15686,0,0,0,0.47,0.0,inf,15760,0,0.0,Americas
Dominican Republic,660485,4384,0,656101,56,0,0,0.66,0.0,inf,660339,146,0.02,Americas
Ecuador,1056578,36008,0,1020570,4571,43,0,3.41,0.0,inf,1052007,4571,0.43,Americas
Egypt,515698,24809,0,490889,0,0,0,4.81,0.0,inf,515645,53,0.01,Eastern Mediterranean
El Salvador,201785,4230,0,197555,0,0,0,2.1,0.0,inf,201785,0,0.0,Americas
Equatorial Guinea,17212,183,0,17029,0,0,0,1.06,0.0,inf,17210,2,0.01,Africa
Eritrea,10189,103,0,10086,0,0,0,1.01,0.0,inf,10189,0,0.0,Africa
Estonia,614526,2926,0,611600,311,7,0,0.48,0.0,inf,614215,311,0.05,Europe
Eswatini,74158,1423,0,72735,0,0,0,1.92,0.0,inf,74143,15,0.02,Africa
Ethiopia,499794,7572,0,492222,12,0,0,1.52,0.0,inf,499689,105,0.02,Africa
Falkland Islands (Malvinas) (UK),1930,0,0,1930,0,0,0,0.0,0.0,0.0,1930,0,0.0,Africa
Faroe Islands (DK),34658,28,0,34630,0,0,0,0.08,0.0,inf,34658,0,0.0,Europe
Fiji,68864,883,0,67981,0,0,0,1.28,0.0,inf,68848,16,0.02,Western Pacific
Finland,1460857,8821,0,1452036,0,0,0,0.6,0.0,inf,1459198,1659,0.11,Europe
France,38628881,161390,0,38467491,4986,35,0,0.42,0.0,inf,38607203,21678,0.06,Europe
French Guiana,98041,413,0,97628,0,0,0,0.42,0.0,inf,98041,0,0.0,Americas
French Polynesia,77957,649,0,77308,0,0,0,0.83,0.0,inf,77957,0,0.0,Western Pacific
Gabon,48981,306,0,48675,0,0,0,0.62,0.0,inf,48981,0,0.0,Africa
Gambia,12586,372,0,12214,0,0,0,2.96,0.0,inf,12586,0,0.0,Africa
Georgia,1818861,16941,0,1801920,0,0,0,0.93,0.0,inf,1815871,2990,0.16,Europe
Germany,37949446,166999,0,37782447,20502,124,0,0.44,0.0,inf,37861703,87743,0.23,Europe
Ghana,171152,1462,0,169690,0,0,0,0.85,0.0,inf,171140,12,0.01,Africa
Gibraltar (UK),20414,111,0,20303,15,0,0,0.54,0.0,inf,20399,15,0.07,Europe
Greece,5548487,34779,0,5513708,0,0,0,0.63,0.0,inf,5548487,0,0.0,Europe
Greenland (DK),11971,21,0,11950,0,0,0,0.18,0.0,inf,11971,0,0.0,Europe
Grenada,19680,238,0,19442,0,0,0,1.21,0.0,inf,19680,0,0.0,Americas
Guadeloupe (FR),201704,1010,0,200694,0,0,0,0.5,0.0,inf,201704,0,0.0,Americas
Guatemala,1232417,20152,0,1212265,429,1,0,1.64,0.0,inf,1230098,2319,0.19,Americas
Guinea,38240,467,0,37773,0,0,0,1.22,0.0,inf,38240,0,0.0,Africa
Guinea-Bissau,8953,176,0,8777,0,0,0,1.97,0.0,inf,8947,6,0.07,Africa
Guyana,73052,1298,0,71754,20,1,0,1.78,0.0,inf,73003,49,0.07,Americas
Haiti,34076,860,0,33216,0,0,0,2.52,0.0,inf,34076,0,0.0,Americas
Holy See,29,0,0,29,0,0,0,0.0,0.0,0.0,29,0,0.0,Europe
Honduras,471224,11107,0,460117,0,0,0,2.36,0.0,inf,471224,0,0.0,Americas
Hungary,2193272,48707,0,2144565,0,0,0,2.22,0.0,inf,2192448,824,0.04,Europe
Iceland,208921,211,0,208710,82,0,0,0.1,0.0,inf,208839,82,0.04,Europe
India,44685601,530756,0,44154845,102,3,0,1.19,0.0,inf,44684864,737,0.0,South-East Asia
Indonesia,6733215,160873,0,6572342,247,3,0,2.39,0.0,inf,6731696,1519,0.02,South-East Asia
Iran,7565865,144788,0,7421077,187,5,0,1.91,0.0,inf,7565025,840,0.01,Eastern Mediterranean
Iraq,2465545,25375,0,2440170,0,0,0,1.03,0.0,inf,2465545,0,0.0,Eastern Mediterranean
Ireland,1701617,8602,0,1693015,0,0,0,0.51,0.0,inf,1700817,800,0.05,Europe
Israel,4792484,12242,0,4780242,753,2,0,0.26,0.0,inf,4789485,2999,0.06,Europe
Italy,25519067,187551,0,25331516,0,0,0,0.73,0.0,inf,25488166,30901,0.12,Europe
Jamaica,154065,3500,0,150565,160,12,0,2.27,0.0,inf,153629,436,0.28,Americas
Japan,33012986,70931,0,32942055,32070,135,0,0.21,0.0,inf,32827214,185772,0.57,Western Pacific
Jordan,1746997,14122,0,1732875,0,0,0,0.81,0.0,inf,1746997,0,0.0,Eastern Mediterranean
Kazakhstan,1497449,19067,0,1478382,0,1,0,1.27,0.0,inf,1496549,900,0.06,Europe
Kenya,342849,5688,0,337161,0,0,0,1.66,0.0,inf,342817,32,0.01,Africa
Kiribati,5012,18,0,4994,4,0,0,0.36,0.0,inf,5008,4,0.08,Western Pacific
"Korea, North",1,6,0,-5,0,0,0,600.0,0.0,inf,1,0,0.0,
Kosovo,272724,3206,0,269518,11,2,0,1.18,0.0,inf,272631,93,0.03,Europe
Kuwait,662858,2570,0,660288,0,0,0,0.39,0.0,inf,662858,0,0.0,Eastern Mediterranean
Kyrgyzstan,206611,2991,0,203620,0,0,0,1.45,0.0,inf,206599,12,0.01,Europe
Laos,218001,758,0,217243,1,0,0,0.35,0.0,inf,217992,9,0.0,Western Pacific
Latvia,975683,6246,0,969437,34,1,0,0.64,0.0,inf,975499,184,0.02,Europe
Lebanon,1230268,10805,0,1219463,0,0,0,0.88,0.0,inf,1229555,713,0.06,Eastern Mediterranean
Lesotho,34790,723,0,34067,0,0,0,2.08,0.0,inf,34790,0,0.0,Africa
Liberia,8065,294,0,7771,0,0,0,3.65,0.0,inf,8062,3,0.04,Africa
Libya,507170,6437,0,500733,0,0,0,1.27,0.0,inf,507166,4,0.0,Eastern Mediterranean
Liechtenstein,21374,89,0,21285,2,0,0,0.42,0.0,inf,21359,15,0.07,Europe
Lithuania,1300592,9561,0,1291031,578,2,0,0.74,0.0,inf,1298497,2095,0.16,Europe
Luxembourg,315528,1214,0,314314,116,2,0,0.38,0.0,inf,315074,454,0.14,Europe
Madagascar,67849,1421,0,66428,0,0,0,2.09,0.0,inf,67842,7,0.01,Africa
Malawi,88600,2686,0,85914,0,0,0,3.03,0.0,inf,88559,41,0.05,Africa
Malaysia,5039850,36953,0,5002897,200,1,0,0.73,0.0,inf,5038354,1496,0.03,Western Pacific
Maldives,185723,311,0,185412,0,0,0,0.17,0.0,inf,185721,2,0.0,South-East Asia
Mali,32843,743,0,32100,10,0,0,2.26,0.0,inf,32810,33,0.1,Africa
Malta,117248,826,0,116422,82,0,0,0.7,0.0,inf,117166,82,0.07,Europe
Marshall Islands,15590,17,0,15573,0,0,0,0.11,0.0,inf,15584,6,0.04,Western Pacific
Martinique (FR),228756,1091,0,227665,0,0,0,0.48,0.0,inf,228756,0,0.0,Americas
Mauritania,63667,997,0,62670,0,0,0,1.57,0.0,inf,63665,2,0.0,Africa
Mauritius,295161,1044,0,294117,0,0,0,0.35,0.0,inf,294915,246,0.08,Africa
Mayotte (FR),42004,187,0,41817,0,0,0,0.45,0.0,inf,42002,2,0.0,Africa
Mexico,7410093,332653,0,7077440,9245,73,0,4.49,0.0,inf,7390230,19863,0.27,Americas
Micronesia,23671,60,0,23611,0,0,0,0.25,0.0,inf,22676,995,4.39,Western Pacific
Moldova,600916,11964,0,588952,1338,7,0,1.99,0.0,inf,599578,1338,0.22,Europe
Monaco,16103,67,0,16036,6,0,0,0.42,0.0,inf,16087,16,0.1,Europe
Mongolia,1007890,2136,0,1005754,0,0,0,0.21,0.0,inf,1007876,14,0.0,Western Pacific
Montenegro,287070,2799,0,284271,104,0,0,0.98,0.0,inf,286617,453,0.16,Europe
Montserrat (UK),1403,8,0,1395,0,0,0,0.57,0.0,inf,1403,0,0.0,Americas
Morocco,1272344,16296,0,1256048,5,0,0,1.28,0.0,inf,1272299,45,0.0,Eastern Mediterranean
Mozambique,232819,2237,0,230582,0,0,0,0.96,0.0,inf,232819,0,0.0,Africa
Namibia,171059,4090,0,166969,0,0,0,2.39,0.0,inf,170741,318,0.19,Africa
Nauru,5121,1,0,5120,306,0,0,0.02,0.0,inf,4621,500,10.82,Western Pacific
Nepal,1001118,12020,0,989098,2,0,0,1.2,0.0,inf,1001107,11,0.0,South-East Asia
Netherlands,8587780,22990,0,8564790,1547,0,0,0.27,0.0,inf,8584886,2894,0.03,Europe
New Zealand,2207348,2515,0,2204833,0,0,0,0.11,0.0,inf,2198982,8366,0.38,Western Pacific
Nicaragua,15612,245,0,15367,0,0,0,1.57,0.0,inf,15592,20,0.13,Americas
Niger,9508,315,0,9193,0,0,0,3.31,0.0,inf,9508,0,0.0,Africa
Nigeria,266463,3155,0,263308,0,0,0,1.18,0.0,inf,266463,0,0.0,Africa
North Macedonia,346733,9653,0,337080,200,12,0,2.78,0.0,inf,346533,200,0.06,Europe
Norway,1478434,5152,0,1473282,39,0,0,0.35,0.0,inf,1478148,286,0.02,Europe
Oman,399449,4628,0,394821,0,0,0,1.16,0.0,inf,399449,0,0.0,Eastern Mediterranean
Pakistan,1576572,30640,0,1545932,21,0,0,1.94,0.0,inf,1576426,146,0.01,Eastern Mediterranean
Palau,5988,9,0,5979,0,0,0,0.15,0.0,inf,5987,1,0.02,Western Pacific
Panama,1030658,8600,0,1022058,0,0,0,0.83,0.0,inf,1030214,444,0.04,Americas
Papua New Guinea,46792,670,0,46122,16,0,0,1.43,0.0,inf,46750,42,0.09,Western Pacific
Paraguay,806790,19843,0,786947,0,0,0,2.46,0.0,inf,806662,128,0.02,Americas
Peru,4484029,219293,0,4264736,300,24,0,4.89,0.0,inf,4482852,1177,0.03,Americas
Philippines,4074821,65968,0,4008853,0,10,0,1.62,0.0,inf,4073980,841,0.02,Western Pacific
Poland,6392257,118785,0,6273472,2316,6,0,1.86,0.0,inf,6384670,7587,0.12,Europe
Portugal,5566314,26103,0,5540211,835,44,0,0.47,0.0,inf,5564925,1389,0.02,Europe
Qatar,492966,686,0,492280,0,0,0,0.14,0.0,inf,492833,133,0.03,Eastern Mediterranean
Reunion (FR),494595,921,0,493674,0,0,0,0.19,0.0,inf,493902,693,0.14,Africa
Romania,3331005,67650,0,3263355,0,0,0,2.03,0.0,inf,3327805,3200,0.1,Europe
Russia,21783243,387654,0,21395589,9761,34,0,1.78,0.0,inf,21702774,80469,0.37,Europe
Rwanda,133148,1468,0,131680,0,0,0,1.1,0.0,inf,133090,58,0.04,Africa
Saint Kitts and Nevis,6595,46,0,6549,1,0,0,0.7,0.0,inf,6592,3,0.05,Americas
Saint Lucia,29882,409,0,29473,0,0,0,1.37,0.0,inf,29882,0,0.0,Americas
Saint Pierre and Miquelon (FR),3452,2,0,3450,0,0,0,0.06,0.0,inf,3452,0,0.0,Americas
Saint Vincent and the Grenadines,9589,123,0,9466,2,0,0,1.28,0.0,inf,9587,2,0.02,Americas
Samoa,16402,29,0,16373,0,0,0,0.18,0.0,inf,16109,293,1.82,Western Pacific
San Marino,23494,122,0,23372,26,0,0,0.52,0.0,inf,23468,26,0.11,Europe
Sao Tome and Principe,6280,77,0,6203,0,0,0,1.23,0.0,inf,6280,0,0.0,Africa
Saudi Arabia,828662,9595,0,819067,67,2,0,1.16,0.0,inf,828294,368,0.04,Eastern Mediterranean
Senegal,88906,1971,0,86935,0,0,0,2.22,0.0,inf,88902,4,0.0,Africa
Serbia,2481396,17744,0,2463652,908,3,0,0.72,0.0,inf,2476392,5004,0.2,Europe
Seychelles,50665,172,0,50493,0,0,0,0.34,0.0,inf,50665,0,0.0,Africa
Sierra Leone,7760,126,0,7634,0,0,0,1.62,0.0,inf,7760,0,0.0,Africa
Singapore,2222006,1722,0,2220284,0,0,0,0.08,0.0,inf,2220062,1944,0.09,Western Pacific
Sint Maarten (NL),11016,91,0,10925,0,0,0,0.83,0.0,inf,11014,2,0.02,Americas
Slovakia,2662668,20986,0,2641682,315,4,0,0.79,0.0,inf,2661623,1045,0.04,Europe
Slovenia,1324306,7065,0,1317241,490,1,0,0.53,0.0,inf,1322911,1395,0.11,Europe
Solomon Islands,24575,153,0,24422,0,0,0,0.62,0.0,inf,24575,0,0.0,Western Pacific
Somalia,27324,1361,0,25963,2,0,0,4.98,0.0,inf,27322,2,0.01,Eastern Mediterranean
South Africa,4059348,102595,0,3956753,382,0,0,2.53,0.0,inf,4057211,2137,0.05,Africa
South Korea,30384701,33782,0,30350919,14957,24,0,0.11,0.0,inf,30297315,87386,0.29,Western Pacific
South Sudan,18368,138,0,18230,0,0,0,0.75,0.0,inf,18368,0,0.0,Africa
Spain,13748918,118976,0,13629942,0,0,0,0.87,0.0,inf,13740531,8387,0.06,Europe
Sri Lanka,672015,16829,0,655186,3,0,0,2.5,0.0,inf,672003,12,0.0,South-East Asia
Sudan,63775,5011,0,58764,0,0,0,7.86,0.0,inf,63759,16,0.03,Eastern Mediterranean
Summer Olympics 2020,865,0,0,865,0,0,0,0.0,0.0,0.0,865,0,0.0,
Suriname,82227,1400,0,80827,0,0,0,1.7,0.0,inf,82227,0,0.0,Americas
Sweden,2696168,23563,0,2672605,0,0,0,0.87,0.0,inf,2694893,1275,0.05,Europe
Switzerland,4409828,14202,0,4395626,995,0,0,0.32,0.0,inf,4408833,995,0.02,Europe
Syria,57461,3164,0,54297,8,0,0,5.51,0.0,inf,57453,8,0.01,Eastern Mediterranean
Taiwan*,9842257,17193,0,9825064,20502,36,0,0.17,0.0,inf,9708863,133394,1.37,Western Pacific
Tajikistan,17786,125,0,17661,0,0,0,0.7,0.0,inf,17786,0,0.0,Europe
Tanzania,42717,846,0,41871,0,0,0,1.98,0.0,inf,42664,53,0.12,Africa
Thailand,4727628,33894,0,4693734,0,0,0,0.72,0.0,inf,4727236,392,0.01,South-East Asia
Timor-Leste,23417,138,0,23279,0,0,0,0.59,0.0,inf,23416,1,0.0,South-East Asia
Togo,39362,290,0,39072,0,0,0,0.74,0.0,inf,39358,4,0.01,Africa
Tonga,16795,13,0,16782,0,0,0,0.08,0.0,inf,16779,16,0.1,Western Pacific
Trinidad and Tobago,188511,4336,0,184175,312,5,0,2.3,0.0,inf,187908,603,0.32,Americas
Tunisia,1150606,29326,0,1121280,129,14,0,2.55,0.0,inf,1150477,129,0.01,Eastern Mediterranean
Turkey,17042722,101492,0,16941230,0,0,0,0.6,0.0,inf,17042722,0,0.0,Europe
Turks and Caicos Islands (UK),6537,38,0,6499,0,0,0,0.58,0.0,inf,6537,0,0.0,Americas
Tuvalu,2805,0,0,2805,0,0,0,0.0,0.0,0.0,2805,0,0.0,Western Pacific
US,102904309,1114990,0,101789319,33940,445,0,1.08,0.0,inf,102668701,235608,0.23,Americas
Uganda,170464,3630,0,166834,0,0,0,2.13,0.0,inf,170400,64,0.04,Africa
Ukraine,5687118,119093,0,5568025,65,1,0,2.09,0.0,inf,5682773,4345,0.08,Europe
United Arab Emirates,1050549,2348,0,1048201,147,0,0,0.22,0.0,inf,1049944,605,0.06,Eastern Mediterranean
United Kingdom,24473981,218206,0,24255775,0,0,0,0.89,0.0,inf,24451691,22290,0.09,Europe
Uruguay,1033766,7617,0,1026149,501,3,0,0.74,0.0,inf,1033265,501,0.05,Americas
Uzbekistan,250799,1637,0,249162,0,0,0,0.65,0.0,inf,250681,118,0.05,Europe
Vanuatu,12014,14,0,12000,0,0,0,0.12,0.0,inf,12014,0,0.0,Western Pacific
Venezuela,551804,5851,0,545953,3,0,0,1.06,0.0,inf,551647,157,0.03,Americas
Vietnam,11526754,43186,0,11483568,50,0,0,0.37,0.0,inf,11526591,163,0.0,Western Pacific
West Bank and Gaza,703228,5708,0,697520,0,0,0,0.81,0.0,inf,703228,0,0.0,Eastern Mediterranean
Winter Olympics 2022,535,0,0,535,0,0,0,0.0,0.0,0.0,535,0,0.0,
Yemen,11945,2159,0,9786,0,0,0,18.07,0.0,inf,11945,0,0.0,Eastern Mediterranean
Zambia,342317,4051,0,338266,0,0,0,1.18,0.0,inf,341690,627,0.18,Africa
Zimbabwe,263083,5659,0,257424,0,0,0,2.15,0.0,inf,262324,759,0.29,Africa
