Country,Confirmed,Deaths,Recovered,Active,New cases,New deaths,New recovered,Deaths / 100 Cases,Recovered / 100 Cases,Deaths / 100 Recovered,Confirmed last week,1 week change,1 week % increase,WHO Region
Afghanistan,182149,7717,0,174432,77,0,0,4.24,0.0,inf,181666,483,0.27,Eastern Mediterranean
Albania,279077,3497,0,275580,284,0,0,1.25,0.0,inf,277409,1668,0.6,Europe
Algeria,266038,6875,0,259163,8,0,0,2.58,0.0,inf,265975,63,0.02,Africa
Andorra,43774,153,0,43621,0,0,0,0.35,0.0,inf,43449,325,0.75,Europe
Angola,99761,1900,0,97861,0,0,0,1.9,0.0,inf,99761,0,0.0,Africa
Anguilla (UK),3411,9,0,3402,0,0,0,0.26,0.0,inf,3374,37,1.1,Americas
Antarctica,11,0,0,11,0,0,0,0.0,0.0,0.0,11,0,0.0,
Antigua and Barbuda,8625,141,0,8484,0,0,0,1.63,0.0,inf,8581,44,0.51,Americas
Argentina,9367172,129070,0,9238102,25680,54,0,1.38,0.0,inf,9341492,25680,0.27,Americas
Armenia,423104,8629,0,414475,0,0,0,2.04,0.0,inf,423044,60,0.01,Europe
Aruba (NL),40595,221,0,40374,0,0,0,0.54,0.0,inf,39980,615,1.54,Americas
Australia,8026309,9705,0,8016604,25997,23,0,0.12,0.0,inf,7825659,200650,2.56,Western Pacific
Austria,4400566,20015,0,4380551,0,0,0,0.45,0.0,inf,4349916,50650,1.16,Europe
Azerbaijan,793164,9717,0,783447,24,0,0,1.23,0.0,inf,793010,154,0.02,Europe
Bahamas,35835,817,0,35018,21,1,0,2.28,0.0,inf,35644,191,0.54,Americas
Bahrain,618498,1492,0,617006,1910,0,0,0.24,0.0,inf,605756,12742,2.1,Eastern Mediterranean
Bangladesh,1965173,29140,0,1936033,1680,2,0,1.48,0.0,inf,1956327,8846,0.45,South-East Asia
Barbados,83776,473,0,83303,113,0,0,0.56,0.0,inf,82899,877,1.06,Americas
Belarus,982867,6978,0,975889,0,0,0,0.71,0.0,inf,982867,0,0.0,Europe
Belgium,4211511,31883,0,4179628,0,0,0,0.76,0.0,inf,4187940,23571,0.56,Europe
Belize,63037,679,0,62358,0,0,0,1.08,0.0,inf,61918,1119,1.81,Americas
Benin,27122,163,0,26959,0,0,0,0.6,0.0,inf,27122,0,0.0,Africa
Bhutan,59674,21,0,59653,0,0,0,0.04,0.0,inf,59644,30,0.05,South-East Asia
Bolivia,921104,21953,0,899151,509,0,0,2.38,0.0,inf,915500,5604,0.61,Americas
Bosnia and Herzegovina,378413,15799,0,362614,0,0,0,4.18,0.0,inf,378209,204,0.05,Europe
Botswana,318528,2719,0,315809,0,0,0,0.85,0.0,inf,314242,4286,1.36,Africa
Brazil,32023166,670229,0,31352937,0,0,0,2.09,0.0,inf,31611769,411397,1.3,Americas
British Virgin Islands (UK),6941,63,0,6878,0,0,0,0.91,0.0,inf,6941,0,0.0,Americas
Brunei,159591,225,0,159366,0,0,0,0.14,0.0,inf,156452,3139,2.01,Western Pacific
Bulgaria,1170091,37246,0,1132845,123,0,0,3.18,0.0,inf,1168127,1964,0.17,Europe
Burkina Faso,21044,387,0,20657,0,0,0,1.84,0.0,inf,21044,0,0.0,Africa
Burma,613556,19434,0,594122,3,0,0,3.17,0.0,inf,613490,66,0.01,South-East Asia
Burundi,42542,38,0,42504,0,0,0,0.09,0.0,inf,42398,144,0.34,Africa
Cabo Verde,59416,403,0,59013,151,0,0,0.68,0.0,inf,58176,1240,2.13,Africa
Cambodia,136262,3056,0,133206,0,0,0,2.24,0.0,inf,136262,0,0.0,Western Pacific
Cameroon,120002,1930,0,118072,0,0,0,1.61,0.0,inf,119947,55,0.05,Africa
Canada,3941172,41877,0,3899295,682,2,0,1.06,0.0,inf,3925875,15297,0.39,Americas
Cayman Islands (UK),27171,28,0,27143,0,0,0,0.1,0.0,inf,26797,374,1.4,Americas
Central African Republic,14649,113,0,14536,0,0,0,0.77,0.0,inf,14649,0,0.0,Africa
Chad,7424,193,0,7231,0,0,0,2.6,0.0,inf,7420,4,0.05,Africa
Chile,3959325,58416,0,3900909,11313,31,0,1.48,0.0,inf,3893726,65599,1.68,Americas
China,2126233,14624,0,2111609,2024,0,0,0.69,0.0,inf,2114127,12106,0.57,Western Pacific
Colombia,6151354,139970,0,6011384,0,0,0,2.28,0.0,inf,6131657,19697,0.32,Americas
Comoros,8136,160,0,7976,0,0,0,1.97,0.0,inf,8131,5,0.06,Africa
Congo (Brazzaville),24128,385,0,23743,0,0,0,1.6,0.0,inf,24128,0,0.0,Africa
Congo (Kinshasa),91082,1371,0,89711,0,0,0,1.51,0.0,inf,89932,1150,1.28,Africa
Costa Rica,904934,8525,0,896409,0,0,0,0.94,0.0,inf,904934,0,0.0,Americas
Cote d'Ivoire,83049,805,0,82244,50,0,0,0.97,0.0,inf,82724,325,0.39,Africa
Croatia,1145490,16050,0,1129440,437,2,0,1.4,0.0,inf,1141919,3571,0.31,Europe
Cuba,1105924,8529,0,1097395,28,0,0,0.77,0.0,inf,1105753,171,0.02,Americas
Curacao (NL),44440,278,0,44162,0,0,0,0.63,0.0,inf,44314,126,0.28,Americas
Cyprus,504717,1072,0,503645,0,0,0,0.21,0.0,inf,497454,7263,1.46,Europe
Czechia,3929153,40313,0,3888840,117,0,0,1.03,0.0,inf,3925358,3795,0.1,Europe
Denmark,3161148,6438,0,3154710,0,0,0,0.2,0.0,inf,3150599,10549,0.33,Europe
Djibouti,15690,189,0,15501,0,0,0,1.2,0.0,inf,15690,0,0.0,Eastern Mediterranean
Dominica,14821,67,0,14754,0,0,0,0.45,0.0,inf,14781,40,0.27,Americas
Dominican Republic,603256,4383,0,598873,2846,0,0,0.73,0.0,inf,595927,7329,1.23,Americas
Ecuador,901739,35705,0,866034,0,0,0,3.96,0.0,inf,896483,5256,0.59,Americas
Egypt,515645,24722,0,490923,0,0,0,4.79,0.0,inf,515645,0,0.0,Eastern Mediterranean
El Salvador,169646,4139,0,165507,0,0,0,2.44,0.0,inf,164134,5512,3.36,Americas
Equatorial Guinea,15995,183,0,15812,0,0,0,1.14,0.0,inf,15951,44,0.28,Africa
Eritrea,9788,103,0,9685,0,0,0,1.05,0.0,inf,9777,11,0.11,Africa
Estonia,579316,2588,0,576728,0,0,0,0.45,0.0,inf,578494,822,0.14,Europe
Eswatini,73073,1415,0,71658,2,0,0,1.94,0.0,inf,73006,67,0.09,Africa
Ethiopia,487430,7530,0,479900,213,0,0,1.54,0.0,inf,484138,3292,0.68,Africa
Falkland Islands (Malvinas) (UK),1807,0,0,1807,0,0,0,0.0,0.0,0.0,1756,51,2.9,Africa
Faroe Islands (DK),34658,28,0,34630,0,0,0,0.08,0.0,inf,34658,0,0.0,Europe
Fiji,65465,865,0,64600,0,0,0,1.32,0.0,inf,65268,197,0.3,Western Pacific
Finland,1133597,4832,0,1128765,0,0,0,0.43,0.0,inf,1125342,8255,0.73,Europe
France,29738074,146405,0,29591669,0,0,0,0.49,0.0,inf,29315828,422246,1.44,Europe
French Guiana,85596,400,0,85196,0,0,0,0.47,0.0,inf,84507,1089,1.29,Americas
French Polynesia,73234,649,0,72585,0,0,0,0.89,0.0,inf,73142,92,0.13,Western Pacific
Gabon,47824,305,0,47519,0,0,0,0.64,0.0,inf,47742,82,0.17,Africa
Gambia,12002,365,0,11637,0,0,0,3.04,0.0,inf,12002,0,0.0,Africa
Georgia,1659371,16839,0,1642532,0,0,0,1.01,0.0,inf,1658755,616,0.04,Europe
Germany,27771911,140734,0,27631177,799,0,0,0.51,0.0,inf,27211896,560015,2.06,Europe
Ghana,164843,1448,0,163395,0,0,0,0.88,0.0,inf,163666,1177,0.72,Africa
Gibraltar (UK),19306,104,0,19202,0,0,0,0.54,0.0,inf,19010,296,1.56,Europe
Greece,3616874,30178,0,3586696,9294,16,0,0.83,0.0,inf,3545112,71762,2.02,Europe
Greenland (DK),11971,21,0,11950,0,0,0,0.18,0.0,inf,11971,0,0.0,Europe
Grenada,18270,232,0,18038,0,0,0,1.27,0.0,inf,18115,155,0.86,Americas
Guadeloupe (FR),166424,950,0,165474,0,0,0,0.57,0.0,inf,164325,2099,1.28,Americas
Guatemala,896850,18497,0,878353,717,6,0,2.06,0.0,inf,880467,16383,1.86,Americas
Guinea,36817,442,0,36375,0,0,0,1.2,0.0,inf,36817,0,0.0,Africa
Guinea-Bissau,8348,171,0,8177,0,0,0,2.05,0.0,inf,8307,41,0.49,Africa
Guyana,67099,1251,0,65848,41,0,0,1.86,0.0,inf,66491,608,0.91,Americas
Haiti,31301,837,0,30464,0,0,0,2.67,0.0,inf,31054,247,0.8,Americas
Holy See,29,0,0,29,0,0,0,0.0,0.0,0.0,29,0,0.0,Europe
Honduras,426490,10904,0,415586,0,0,0,2.56,0.0,inf,426095,395,0.09,Americas
Hungary,1925083,46626,0,1878457,0,0,0,2.42,0.0,inf,1923122,1961,0.1,Europe
Iceland,192991,153,0,192838,0,0,0,0.08,0.0,inf,191079,1912,1.0,Europe
India,43407046,525020,0,42882026,17073,21,0,1.21,0.0,inf,43309473,97573,0.23,South-East Asia
Indonesia,6080451,156717,0,5923734,1726,3,0,2.58,0.0,inf,6068075,12376,0.2,South-East Asia
Iran,7236361,141385,0,7094976,297,2,0,1.95,0.0,inf,7234757,1604,0.02,Eastern Mediterranean
Iraq,2339148,25231,0,2313917,1039,2,0,1.08,0.0,inf,2332177,6971,0.3,Eastern Mediterranean
Ireland,1587385,7469,0,1579916,0,0,0,0.47,0.0,inf,1578284,9101,0.58,Europe
Israel,4301600,10940,0,4290660,8527,14,0,0.25,0.0,inf,4233759,67841,1.6,Europe
Italy,18234242,168102,0,18066140,49325,44,0,0.92,0.0,inf,17879160,355082,1.99,Europe
Jamaica,142440,3119,0,139321,279,7,0,2.19,0.0,inf,141306,1134,0.8,Americas
Japan,9241386,31125,0,9210261,14206,12,0,0.34,0.0,inf,9137595,103791,1.14,Western Pacific
Jordan,1698316,14068,0,1684248,0,0,0,0.83,0.0,inf,1697673,643,0.04,Eastern Mediterranean
Kazakhstan,1395466,19018,0,1376448,67,0,0,1.36,0.0,inf,1395167,299,0.02,Europe
Kenya,332227,5652,0,326575,261,1,0,1.7,0.0,inf,329353,2874,0.87,Africa
Kiribati,3236,13,0,3223,0,0,0,0.4,0.0,inf,3215,21,0.65,Western Pacific
"Korea, North",1,6,0,-5,0,0,0,600.0,0.0,inf,1,0,0.0,
Kosovo,228673,3140,0,225533,0,0,0,1.37,0.0,inf,228540,133,0.06,Europe
Kuwait,641985,2555,0,639430,0,0,0,0.4,0.0,inf,638708,3277,0.51,Eastern Mediterranean
Kyrgyzstan,201024,2991,0,198033,0,0,0,1.49,0.0,inf,201016,8,0.0,Europe
Laos,210247,757,0,209490,9,0,0,0.36,0.0,inf,210194,53,0.03,Western Pacific
Latvia,832884,5855,0,827029,0,0,0,0.7,0.0,inf,831727,1157,0.14,Europe
Lebanon,1108213,10461,0,1097752,611,1,0,0.94,0.0,inf,1103264,4949,0.45,Eastern Mediterranean
Lesotho,33938,699,0,33239,0,0,0,2.06,0.0,inf,33746,192,0.57,Africa
Liberia,7493,294,0,7199,0,0,0,3.92,0.0,inf,7489,4,0.05,Africa
Libya,502110,6430,0,495680,0,0,0,1.28,0.0,inf,502076,34,0.01,Eastern Mediterranean
Liechtenstein,17814,85,0,17729,0,0,0,0.48,0.0,inf,17653,161,0.91,Europe
Lithuania,1159506,9163,0,1150343,56,0,0,0.79,0.0,inf,1065163,94343,8.86,Europe
Luxembourg,258467,1088,0,257379,0,0,0,0.42,0.0,inf,254865,3602,1.41,Europe
Madagascar,65381,1398,0,63983,372,0,0,2.14,0.0,inf,65009,372,0.57,Africa
Malawi,86348,2645,0,83703,0,0,0,3.06,0.0,inf,86204,144,0.17,Africa
Malaysia,4556664,35746,0,4520918,2003,1,0,0.78,0.0,inf,4540612,16052,0.35,Western Pacific
Maldives,180384,300,0,180084,0,0,0,0.17,0.0,inf,179979,405,0.23,South-East Asia
Mali,31156,737,0,30419,3,0,0,2.37,0.0,inf,31137,19,0.06,Africa
Malta,101036,740,0,100296,442,0,0,0.73,0.0,inf,97872,3164,3.23,Europe
Marshall Islands,18,0,0,18,0,0,0,0.0,0.0,0.0,18,0,0.0,Western Pacific
Martinique (FR),188959,957,0,188002,0,0,0,0.51,0.0,inf,180883,8076,4.46,Americas
Mauritania,59451,982,0,58469,23,0,0,1.65,0.0,inf,59304,147,0.25,Africa
Mauritius,229479,1002,0,228477,0,0,0,0.44,0.0,inf,227442,2037,0.9,Africa
Mayotte (FR),37877,187,0,37690,0,0,0,0.49,0.0,inf,37820,57,0.15,Africa
Mexico,5962615,325580,0,5637035,5883,4,0,5.46,0.0,inf,5875705,86910,1.48,Americas
Micronesia,38,0,0,38,0,0,0,0.0,0.0,0.0,38,0,0.0,Western Pacific
Moldova,519741,11563,0,508178,0,0,0,2.22,0.0,inf,519452,289,0.06,Europe
Monaco,12808,57,0,12751,0,0,0,0.45,0.0,inf,12616,192,1.52,Europe
Mongolia,926282,2179,0,924103,0,0,0,0.24,0.0,inf,926282,0,0.0,Western Pacific
Montenegro,239458,2724,0,236734,167,0,0,1.14,0.0,inf,238486,972,0.41,Europe
Montserrat (UK),1016,8,0,1008,0,0,0,0.79,0.0,inf,1015,1,0.1,Americas
Morocco,1204578,16101,0,1188477,2117,3,0,1.34,0.0,inf,1185990,18588,1.57,Eastern Mediterranean
Mozambique,227644,2212,0,225432,28,0,0,0.97,0.0,inf,227127,517,0.23,Africa
Namibia,169076,4061,0,165015,0,0,0,2.4,0.0,inf,168868,208,0.12,Africa
Nepal,979533,11952,0,967581,21,0,0,1.22,0.0,inf,979362,171,0.02,South-East Asia
Netherlands,8152685,22354,0,8130331,0,0,0,0.27,0.0,inf,8122170,30515,0.38,Europe
New Zealand,1319913,1422,0,1318491,5758,11,0,0.11,0.0,inf,1283295,36618,2.85,Western Pacific
Nicaragua,14619,241,0,14378,0,0,0,1.65,0.0,inf,14619,0,0.0,Americas
Niger,9031,310,0,8721,0,0,0,3.43,0.0,inf,9031,0,0.0,Africa
Nigeria,256958,3144,0,253814,0,0,0,1.22,0.0,inf,256573,385,0.15,Africa
North Macedonia,313360,9322,0,304038,0,0,0,2.97,0.0,inf,312879,481,0.15,Europe
Norway,1444193,3280,0,1440913,150,0,0,0.23,0.0,inf,1439751,4442,0.31,Europe
Oman,390244,4628,0,385616,0,0,0,1.19,0.0,inf,389758,486,0.12,Eastern Mediterranean
Pakistan,1534270,30390,0,1503880,788,4,0,1.98,0.0,inf,1532153,2117,0.14,Eastern Mediterranean
Palau,5201,6,0,5195,0,0,0,0.12,0.0,inf,5181,20,0.39,Western Pacific
Panama,915057,8347,0,906710,1125,1,0,0.91,0.0,inf,903529,11528,1.28,Americas
Papua New Guinea,44702,662,0,44040,0,0,0,1.48,0.0,inf,44681,21,0.05,Western Pacific
Paraguay,655532,18963,0,636569,0,0,0,2.89,0.0,inf,653428,2104,0.32,Americas
Peru,3613464,213462,0,3400002,0,15,0,5.91,0.0,inf,3599501,13963,0.39,Americas
Philippines,3700876,60518,0,3640358,848,11,0,1.64,0.0,inf,3696264,4612,0.12,Western Pacific
Poland,6013076,116417,0,5896659,97,0,0,1.94,0.0,inf,6011239,1837,0.03,Europe
Portugal,5120970,24013,0,5096957,0,0,0,0.47,0.0,inf,5005783,115187,2.3,Europe
Qatar,379862,679,0,379183,585,1,0,0.18,0.0,inf,375481,4381,1.17,Eastern Mediterranean
Reunion (FR),421269,807,0,420462,0,0,0,0.19,0.0,inf,419968,1301,0.31,Africa
Romania,2915487,65726,0,2849761,0,0,0,2.25,0.0,inf,2912878,2609,0.09,Europe
Russia,18150010,373189,0,17776821,2966,55,0,2.06,0.0,inf,18129625,20385,0.11,Europe
Rwanda,130819,1459,0,129360,32,0,0,1.12,0.0,inf,130568,251,0.19,Africa
Saint Kitts and Nevis,5941,43,0,5898,0,0,0,0.72,0.0,inf,5910,31,0.52,Americas
Saint Lucia,26937,380,0,26557,26,0,0,1.41,0.0,inf,26722,215,0.8,Americas
Saint Pierre and Miquelon (FR),2767,1,0,2766,0,0,0,0.04,0.0,inf,2767,0,0.0,Americas
Saint Vincent and the Grenadines,9026,111,0,8915,0,0,0,1.23,0.0,inf,8956,70,0.78,Americas
Samoa,14812,29,0,14783,0,0,0,0.2,0.0,inf,14497,315,2.17,Western Pacific
San Marino,17719,115,0,17604,0,0,0,0.65,0.0,inf,17413,306,1.76,Europe
Sao Tome and Principe,6023,73,0,5950,0,0,0,1.21,0.0,inf,6010,13,0.22,Africa
Saudi Arabia,791784,9201,0,782583,3490,7,0,1.16,0.0,inf,784837,6947,0.89,Eastern Mediterranean
Senegal,86280,1968,0,84312,5,0,0,2.28,0.0,inf,86201,79,0.09,Africa
Serbia,2026045,16121,0,2009924,468,1,0,0.8,0.0,inf,2022494,3551,0.18,Europe
Seychelles,44669,167,0,44502,0,0,0,0.37,0.0,inf,44521,148,0.33,Africa
Sierra Leone,7694,125,0,7569,1,0,0,1.62,0.0,inf,7688,6,0.08,Africa
Singapore,1408358,1408,0,1406950,5116,0,0,0.1,0.0,inf,1367761,40597,2.97,Western Pacific
Sint Maarten (NL),10537,86,0,10451,0,0,0,0.82,0.0,inf,10508,29,0.28,Americas
Slovakia,2548819,20142,0,2528677,233,0,0,0.79,0.0,inf,2546134,2685,0.11,Europe
Slovenia,1034172,6648,0,1027524,0,0,0,0.64,0.0,inf,1030354,3818,0.37,Europe
Solomon Islands,21544,153,0,21391,0,0,0,0.71,0.0,inf,21544,0,0.0,Western Pacific
Somalia,26748,1361,0,25387,0,0,0,5.09,0.0,inf,26675,73,0.27,Eastern Mediterranean
South Africa,3992449,101731,0,3890718,505,4,0,2.55,0.0,inf,3986601,5848,0.15,Africa
South Korea,18329448,24525,0,18304923,3429,3,0,0.13,0.0,inf,18280090,49358,0.27,Western Pacific
South Sudan,17697,138,0,17559,0,0,0,0.78,0.0,inf,17697,0,0.0,Africa
Spain,12681820,107799,0,12574021,0,0,0,0.85,0.0,inf,12563399,118421,0.94,Europe
Sri Lanka,664080,16521,0,647559,15,0,0,2.49,0.0,inf,663989,91,0.01,South-East Asia
Sudan,62551,4951,0,57600,0,0,0,7.92,0.0,inf,62489,62,0.1,Eastern Mediterranean
Summer Olympics 2020,865,0,0,865,0,0,0,0.0,0.0,0.0,865,0,0.0,
Suriname,80817,1359,0,79458,0,0,0,1.68,0.0,inf,80766,51,0.06,Americas
Sweden,2515769,19093,0,2496676,0,0,0,0.76,0.0,inf,2512853,2916,0.12,Europe
Switzerland,3726615,13822,0,3712793,0,0,0,0.37,0.0,inf,3701895,24720,0.67,Europe
Syria,55920,3150,0,52770,0,0,0,5.63,0.0,inf,55913,7,0.01,Eastern Mediterranean
Taiwan*,3613345,6254,0,3607091,39642,134,0,0.17,0.0,inf,3295076,318269,9.66,Western Pacific
Tajikistan,17786,125,0,17661,0,0,0,0.7,0.0,inf,17786,0,0.0,Europe
Tanzania,35366,841,0,34525,0,0,0,2.38,0.0,inf,35354,12,0.03,Africa
Thailand,4514155,30592,0,4483563,0,0,0,0.68,0.0,inf,4500828,13327,0.3,South-East Asia
Timor-Leste,22950,133,0,22817,0,0,0,0.58,0.0,inf,22944,6,0.03,South-East Asia
Togo,37348,275,0,37073,20,0,0,0.74,0.0,inf,37247,101,0.27,Africa
Tonga,12079,12,0,12067,0,0,0,0.1,0.0,inf,12079,0,0.0,Western Pacific
Trinidad and Tobago,166712,4002,0,162710,30,2,0,2.4,0.0,inf,165807,905,0.55,Americas
Tunisia,1046703,28670,0,1018033,0,0,0,2.74,0.0,inf,1044426,2277,0.22,Eastern Mediterranean
Turkey,15085742,98996,0,14986746,0,0,0,0.66,0.0,inf,15085742,0,0.0,Europe
Turks and Caicos Islands (UK),6211,36,0,6175,0,0,0,0.58,0.0,inf,6189,22,0.36,Americas
US,86967399,1015938,0,85951461,18551,5,0,1.17,0.0,inf,86255332,712067,0.83,Americas
Uganda,167452,3621,0,163831,85,1,0,2.16,0.0,inf,166920,532,0.32,Africa
Ukraine,5040518,112459,0,4928059,0,0,0,2.23,0.0,inf,5040518,0,0.0,Europe
United Arab Emirates,938759,2311,0,936448,1722,0,0,0.25,0.0,inf,927387,11372,1.23,Eastern Mediterranean
United Kingdom,22720938,180351,0,22540587,0,0,0,0.79,0.0,inf,22599349,121589,0.54,Europe
Uruguay,951948,7312,0,944636,0,0,0,0.77,0.0,inf,943877,8071,0.86,Americas
Uzbekistan,240345,1637,0,238708,139,0,0,0.68,0.0,inf,239525,820,0.34,Europe
Vanuatu,11173,14,0,11159,129,0,0,0.13,0.0,inf,10924,249,2.28,Western Pacific
Venezuela,525782,5729,0,520053,66,1,0,1.09,0.0,inf,524911,871,0.17,Americas
Vietnam,10743448,43084,0,10700364,557,0,0,0.4,0.0,inf,10737640,5808,0.05,Western Pacific
West Bank and Gaza,658503,5660,0,652843,0,0,0,0.86,0.0,inf,658100,403,0.06,Eastern Mediterranean
Winter Olympics 2022,535,0,0,535,0,0,0,0.0,0.0,0.0,535,0,0.0,
Yemen,11824,2149,0,9675,0,0,0,18.17,0.0,inf,11823,1,0.01,Eastern Mediterranean
Zambia,325110,4003,0,321107,0,0,0,1.23,0.0,inf,324288,822,0.25,Africa
Zimbabwe,255355,5549,0,249806,46,0,0,2.17,0.0,inf,254801,554,0.22,Africa
