Country,Confirmed,Deaths,Recovered,Active,New cases,New deaths,New recovered,Deaths / 100 Cases,Recovered / 100 Cases,Deaths / 100 Recovered,Confirmed last week,1 week change,1 week % increase,WHO Region
Afghanistan,208982,7896,0,201086,11,0,0,3.78,0.0,inf,208627,355,0.17,Eastern Mediterranean
Albania,334255,3596,0,330659,21,0,0,1.08,0.0,inf,334211,44,0.01,Europe
Algeria,271409,6881,0,264528,0,0,0,2.54,0.0,inf,271394,15,0.01,Africa
Andorra,47860,165,0,47695,0,0,0,0.34,0.0,inf,47850,10,0.02,Europe
Angola,105184,1931,0,103253,0,0,0,1.84,0.0,inf,105184,0,0.0,Africa
Anguilla (UK),3904,12,0,3892,0,0,0,0.31,0.0,inf,3904,0,0.0,Americas
Antarctica,11,0,0,11,0,0,0,0.0,0.0,0.0,11,0,0.0,
Antigua and Barbuda,9106,146,0,8960,0,0,0,1.6,0.0,inf,9106,0,0.0,Americas
Argentina,10040329,130437,0,9909892,0,0,0,1.3,0.0,inf,10037135,3194,0.03,Americas
Armenia,446332,8719,0,437613,0,0,0,1.95,0.0,inf,446008,324,0.07,Europe
Aruba (NL),44026,282,0,43744,0,0,0,0.64,0.0,inf,43993,33,0.08,Americas
Australia,11330342,19070,0,11311272,0,0,0,0.17,0.0,inf,11312904,17438,0.15,Western Pacific
Austria,5829303,21788,0,5807515,7777,7,0,0.37,0.0,inf,5801078,28225,0.49,Europe
Azerbaijan,828229,10098,0,818131,19,0,0,1.22,0.0,inf,828082,147,0.02,Europe
Bahamas,37491,833,0,36658,0,0,0,2.22,0.0,inf,37491,0,0.0,Americas
Bahrain,700835,1544,0,699291,0,0,0,0.22,0.0,inf,700835,0,0.0,Eastern Mediterranean
Bangladesh,2037679,29444,0,2008235,15,0,0,1.44,0.0,inf,2037588,91,0.0,South-East Asia
Barbados,106434,573,0,105861,0,0,0,0.54,0.0,inf,106157,277,0.26,Americas
Belarus,994037,7118,0,986919,0,0,0,0.72,0.0,inf,994037,0,0.0,Europe
Belgium,4700949,33616,0,4667333,0,0,0,0.72,0.0,inf,4695403,5546,0.12,Europe
Belize,70697,688,0,70009,0,0,0,0.97,0.0,inf,70660,37,0.05,Americas
Benin,27990,163,0,27827,0,0,0,0.58,0.0,inf,27989,1,0.0,Africa
Bhutan,62608,21,0,62587,0,0,0,0.03,0.0,inf,62605,3,0.0,South-East Asia
Bolivia,1191090,22355,0,1168735,390,1,0,1.88,0.0,inf,1189673,1417,0.12,Americas
Bosnia and Herzegovina,401472,16261,0,385211,0,0,0,4.05,0.0,inf,401412,60,0.01,Europe
Botswana,329494,2801,0,326693,0,0,0,0.85,0.0,inf,329227,267,0.08,Africa
Brazil,36932830,697674,0,36235156,2491,12,0,1.89,0.0,inf,36867401,65429,0.18,Americas
British Virgin Islands (UK),7305,64,0,7241,0,0,0,0.88,0.0,inf,7305,0,0.0,Americas
Brunei,276825,225,0,276600,0,0,0,0.08,0.0,inf,276067,758,0.27,Western Pacific
Bulgaria,1295870,38194,0,1257676,41,0,0,2.95,0.0,inf,1295597,273,0.02,Europe
Burkina Faso,22025,396,0,21629,0,0,0,1.8,0.0,inf,22025,0,0.0,Africa
Burma,633866,19490,0,614376,2,0,0,3.07,0.0,inf,633842,24,0.0,South-East Asia
Burundi,53574,38,0,53536,0,0,0,0.07,0.0,inf,53492,82,0.15,Africa
Cabo Verde,63235,413,0,62822,0,0,0,0.65,0.0,inf,63229,6,0.01,Africa
Cambodia,138704,3056,0,135648,1,0,0,2.2,0.0,inf,138698,6,0.0,Western Pacific
Cameroon,123993,1965,0,122028,0,0,0,1.58,0.0,inf,123993,0,0.0,Africa
Canada,4580032,50918,0,4529114,414,0,0,1.11,0.0,inf,4570297,9735,0.21,Americas
Cayman Islands (UK),31472,37,0,31435,0,0,0,0.12,0.0,inf,31472,0,0.0,Americas
Central African Republic,15368,113,0,15255,0,0,0,0.74,0.0,inf,15368,0,0.0,Africa
Chad,7652,194,0,7458,0,0,0,2.54,0.0,inf,7652,0,0.0,Africa
Chile,5138732,63998,0,5074734,1427,13,0,1.25,0.0,inf,5128130,10602,0.21,Americas
China,4903517,100922,0,4802595,0,0,0,2.06,0.0,inf,4903507,10,0.0,Western Pacific
Colombia,6355637,142276,0,6213361,0,0,0,2.24,0.0,inf,6355135,502,0.01,Americas
Comoros,8992,161,0,8831,0,0,0,1.79,0.0,inf,8992,0,0.0,Africa
Congo (Brazzaville),32818,743,0,32075,0,0,0,2.26,0.0,inf,25375,7443,29.33,Africa
Congo (Kinshasa),95585,1463,0,94122,0,0,0,1.53,0.0,inf,95514,71,0.07,Africa
Costa Rica,1190377,9181,0,1181196,0,0,0,0.77,0.0,inf,1186176,4201,0.35,Americas
Cote d'Ivoire,88063,834,0,87229,17,0,0,0.95,0.0,inf,87997,66,0.08,Africa
Croatia,1268224,17923,0,1250301,39,2,0,1.41,0.0,inf,1267894,330,0.03,Europe
Cuba,1112516,8530,0,1103986,9,0,0,0.77,0.0,inf,1112484,32,0.0,Americas
Curacao (NL),45986,301,0,45685,0,0,0,0.65,0.0,inf,45986,0,0.0,Americas
Cyprus,645515,1293,0,644222,0,0,0,0.2,0.0,inf,644160,1355,0.21,Europe
Czechia,4595326,42348,0,4552978,135,2,0,0.92,0.0,inf,4591500,3826,0.08,Europe
Denmark,3401227,8191,0,3393036,0,0,0,0.24,0.0,inf,3400280,947,0.03,Europe
Djibouti,15690,189,0,15501,0,0,0,1.2,0.0,inf,15690,0,0.0,Eastern Mediterranean
Dominica,15760,74,0,15686,0,0,0,0.47,0.0,inf,15760,0,0.0,Americas
Dominican Republic,660412,4384,0,656028,0,0,0,0.66,0.0,inf,660095,317,0.05,Americas
Ecuador,1052007,35965,0,1016042,0,0,0,3.42,0.0,inf,1052007,0,0.0,Americas
Egypt,515666,24807,0,490859,0,0,0,4.81,0.0,inf,515645,21,0.0,Eastern Mediterranean
El Salvador,201785,4230,0,197555,0,0,0,2.1,0.0,inf,201785,0,0.0,Americas
Equatorial Guinea,17212,183,0,17029,0,0,0,1.06,0.0,inf,17190,22,0.13,Africa
Eritrea,10189,103,0,10086,0,0,0,1.01,0.0,inf,10189,0,0.0,Africa
Estonia,614215,2919,0,611296,0,0,0,0.48,0.0,inf,613903,312,0.05,Europe
Eswatini,74158,1423,0,72735,15,0,0,1.92,0.0,inf,74143,15,0.02,Africa
Ethiopia,499765,7572,0,492193,16,0,0,1.52,0.0,inf,499656,109,0.02,Africa
Falkland Islands (Malvinas) (UK),1930,0,0,1930,0,0,0,0.0,0.0,0.0,1930,0,0.0,Africa
Faroe Islands (DK),34658,28,0,34630,0,0,0,0.08,0.0,inf,34658,0,0.0,Europe
Fiji,68864,883,0,67981,0,0,0,1.28,0.0,inf,68848,16,0.02,Western Pacific
Finland,1460857,8821,0,1452036,0,0,0,0.6,0.0,inf,1459198,1659,0.11,Europe
France,38618226,161307,0,38456919,0,0,0,0.42,0.0,inf,38596071,22155,0.06,Europe
French Guiana,98041,413,0,97628,0,0,0,0.42,0.0,inf,98041,0,0.0,Americas
French Polynesia,77957,649,0,77308,0,0,0,0.83,0.0,inf,77957,0,0.0,Western Pacific
Gabon,48981,306,0,48675,0,0,0,0.62,0.0,inf,48981,0,0.0,Africa
Gambia,12586,372,0,12214,0,0,0,2.96,0.0,inf,12586,0,0.0,Africa
Georgia,1818861,16941,0,1801920,0,0,0,0.93,0.0,inf,1815871,2990,0.16,Europe
Germany,37907312,166763,0,37740549,0,0,0,0.44,0.0,inf,37822577,84735,0.22,Europe
Ghana,171152,1462,0,169690,12,0,0,0.85,0.0,inf,171112,40,0.02,Africa
Gibraltar (UK),20399,111,0,20288,0,0,0,0.54,0.0,inf,20399,0,0.0,Europe
Greece,5548487,34779,0,5513708,0,0,0,0.63,0.0,inf,5548487,0,0.0,Europe
Greenland (DK),11971,21,0,11950,0,0,0,0.18,0.0,inf,11971,0,0.0,Europe
Grenada,19680,238,0,19442,0,0,0,1.21,0.0,inf,19680,0,0.0,Americas
Guadeloupe (FR),201704,1010,0,200694,0,0,0,0.5,0.0,inf,201394,310,0.15,Americas
Guatemala,1231970,20149,0,1211821,463,7,0,1.64,0.0,inf,1229596,2374,0.19,Americas
Guinea,38240,467,0,37773,0,0,0,1.22,0.0,inf,38240,0,0.0,Africa
Guinea-Bissau,8947,176,0,8771,0,0,0,1.97,0.0,inf,8947,0,0.0,Africa
Guyana,73032,1297,0,71735,0,0,0,1.78,0.0,inf,72984,48,0.07,Americas
Haiti,34076,860,0,33216,0,0,0,2.52,0.0,inf,34076,0,0.0,Americas
Holy See,29,0,0,29,0,0,0,0.0,0.0,0.0,29,0,0.0,Europe
Honduras,471224,11107,0,460117,0,0,0,2.36,0.0,inf,470940,284,0.06,Americas
Hungary,2193272,48707,0,2144565,0,0,0,2.22,0.0,inf,2192448,824,0.04,Europe
Iceland,208839,211,0,208628,0,0,0,0.1,0.0,inf,208688,151,0.07,Europe
India,44685425,530753,0,44154672,206,3,0,1.19,0.0,inf,44684679,746,0.0,South-East Asia
Indonesia,6732799,160864,0,6571935,181,4,0,2.39,0.0,inf,6731135,1664,0.02,South-East Asia
Iran,7565552,144781,0,7420771,185,2,0,1.91,0.0,inf,7564756,796,0.01,Eastern Mediterranean
Iraq,2465545,25375,0,2440170,0,0,0,1.03,0.0,inf,2465545,0,0.0,Eastern Mediterranean
Ireland,1701617,8602,0,1693015,0,0,0,0.51,0.0,inf,1700817,800,0.05,Europe
Israel,4791163,12236,0,4778927,398,7,0,0.26,0.0,inf,4788399,2764,0.06,Europe
Italy,25519067,187551,0,25331516,0,0,0,0.73,0.0,inf,25488166,30901,0.12,Europe
Jamaica,153905,3488,0,150417,0,0,0,2.27,0.0,inf,153629,276,0.18,Americas
Japan,32971493,70703,0,32900790,13740,137,0,0.21,0.0,inf,32766847,204646,0.62,Western Pacific
Jordan,1746997,14122,0,1732875,0,0,0,0.81,0.0,inf,1746997,0,0.0,Eastern Mediterranean
Kazakhstan,1496549,19066,0,1477483,0,0,0,1.27,0.0,inf,1496549,0,0.0,Europe
Kenya,342817,5688,0,337129,0,0,0,1.66,0.0,inf,342817,0,0.0,Africa
Kiribati,5008,18,0,4990,0,0,0,0.36,0.0,inf,5008,0,0.0,Western Pacific
"Korea, North",1,6,0,-5,0,0,0,600.0,0.0,inf,1,0,0.0,
Kosovo,272710,3204,0,269506,8,0,0,1.17,0.0,inf,272621,89,0.03,Europe
Kuwait,662858,2570,0,660288,0,0,0,0.39,0.0,inf,662858,0,0.0,Eastern Mediterranean
Kyrgyzstan,206599,2991,0,203608,0,0,0,1.45,0.0,inf,206592,7,0.0,Europe
Laos,217999,758,0,217241,1,0,0,0.35,0.0,inf,217990,9,0.0,Western Pacific
Latvia,975590,6245,0,969345,0,0,0,0.64,0.0,inf,975403,187,0.02,Europe
Lebanon,1230141,10803,0,1219338,226,2,0,0.88,0.0,inf,1229390,751,0.06,Eastern Mediterranean
Lesotho,34790,723,0,34067,0,0,0,2.08,0.0,inf,34790,0,0.0,Africa
Liberia,8065,294,0,7771,0,0,0,3.65,0.0,inf,8062,3,0.04,Africa
Libya,507166,6437,0,500729,0,0,0,1.27,0.0,inf,507162,4,0.0,Eastern Mediterranean
Liechtenstein,21372,89,0,21283,0,0,0,0.42,0.0,inf,21359,13,0.06,Europe
Lithuania,1299971,9555,0,1290416,49,0,0,0.74,0.0,inf,1297880,2091,0.16,Europe
Luxembourg,315352,1212,0,314140,0,0,0,0.38,0.0,inf,314882,470,0.15,Europe
Madagascar,67849,1421,0,66428,7,1,0,2.09,0.0,inf,67842,7,0.01,Africa
Malawi,88559,2686,0,85873,0,0,0,3.03,0.0,inf,88559,0,0.0,Africa
Malaysia,5039486,36951,0,5002535,160,0,0,0.73,0.0,inf,5037995,1491,0.03,Western Pacific
Maldives,185721,311,0,185410,0,0,0,0.17,0.0,inf,185715,6,0.0,South-East Asia
Mali,32833,743,0,32090,7,0,0,2.26,0.0,inf,32790,43,0.13,Africa
Malta,117166,826,0,116340,0,0,0,0.7,0.0,inf,117062,104,0.09,Europe
Marshall Islands,15590,17,0,15573,0,0,0,0.11,0.0,inf,15584,6,0.04,Western Pacific
Martinique (FR),228756,1091,0,227665,0,0,0,0.48,0.0,inf,228512,244,0.11,Americas
Mauritania,63667,997,0,62670,0,0,0,1.57,0.0,inf,63665,2,0.0,Africa
Mauritius,294915,1044,0,293871,0,0,0,0.35,0.0,inf,294602,313,0.11,Africa
Mayotte (FR),42004,187,0,41817,0,0,0,0.45,0.0,inf,42002,2,0.0,Africa
Mexico,7400848,332580,0,7068268,0,0,0,4.49,0.0,inf,7389670,11178,0.15,Americas
Micronesia,23671,60,0,23611,0,0,0,0.25,0.0,inf,22676,995,4.39,Western Pacific
Moldova,599578,11957,0,587621,0,0,0,1.99,0.0,inf,598673,905,0.15,Europe
Monaco,16095,67,0,16028,0,0,0,0.42,0.0,inf,16069,26,0.16,Europe
Mongolia,1007888,2136,0,1005752,0,0,0,0.21,0.0,inf,1007874,14,0.0,Western Pacific
Montenegro,286867,2799,0,284068,71,0,0,0.98,0.0,inf,286493,374,0.13,Europe
Montserrat (UK),1403,8,0,1395,0,0,0,0.57,0.0,inf,1403,0,0.0,Americas
Morocco,1272335,16296,0,1256039,7,0,0,1.28,0.0,inf,1272280,55,0.0,Eastern Mediterranean
Mozambique,232819,2237,0,230582,0,0,0,0.96,0.0,inf,231994,825,0.36,Africa
Namibia,170741,4088,0,166653,0,0,0,2.39,0.0,inf,170741,0,0.0,Africa
Nauru,4815,1,0,4814,0,0,0,0.02,0.0,inf,4621,194,4.2,Western Pacific
Nepal,1001115,12020,0,989095,2,0,0,1.2,0.0,inf,1001106,9,0.0,South-East Asia
Netherlands,8586233,22990,0,8563243,0,0,0,0.27,0.0,inf,8583530,2703,0.03,Europe
New Zealand,2207346,2515,0,2204831,8364,11,0,0.11,0.0,inf,2190121,17225,0.79,Western Pacific
Nicaragua,15612,245,0,15367,0,0,0,1.57,0.0,inf,15592,20,0.13,Americas
Niger,9508,315,0,9193,0,0,0,3.31,0.0,inf,9508,0,0.0,Africa
Nigeria,266463,3155,0,263308,0,0,0,1.18,0.0,inf,266463,0,0.0,Africa
North Macedonia,346533,9641,0,336892,0,0,0,2.78,0.0,inf,346533,0,0.0,Europe
Norway,1478328,5152,0,1473176,41,0,0,0.35,0.0,inf,1478042,286,0.02,Europe
Oman,399449,4628,0,394821,0,0,0,1.16,0.0,inf,399449,0,0.0,Eastern Mediterranean
Pakistan,1576538,30640,0,1545898,74,0,0,1.94,0.0,inf,1576397,141,0.01,Eastern Mediterranean
Palau,5987,9,0,5978,0,0,0,0.15,0.0,inf,5986,1,0.02,Western Pacific
Panama,1030214,8599,0,1021615,0,0,0,0.83,0.0,inf,1029701,513,0.05,Americas
Papua New Guinea,46776,670,0,46106,0,0,0,1.43,0.0,inf,46750,26,0.06,Western Pacific
Paraguay,806790,19843,0,786947,0,0,0,2.46,0.0,inf,806662,128,0.02,Americas
Peru,4483729,219269,0,4264460,286,19,0,4.89,0.0,inf,4482582,1147,0.03,Americas
Philippines,4074691,65949,0,4008742,128,11,0,1.62,0.0,inf,4073826,865,0.02,Western Pacific
Poland,6389741,118779,0,6270962,169,0,0,1.86,0.0,inf,6383096,6645,0.1,Europe
Portugal,5565479,26059,0,5539420,0,0,0,0.47,0.0,inf,5564254,1225,0.02,Europe
Qatar,492966,686,0,492280,41,0,0,0.14,0.0,inf,492647,319,0.06,Eastern Mediterranean
Reunion (FR),493902,919,0,492983,0,0,0,0.19,0.0,inf,493902,0,0.0,Africa
Romania,3327805,67619,0,3260186,0,0,0,2.03,0.0,inf,3325006,2799,0.08,Europe
Russia,21762542,387590,0,21374952,12231,30,0,1.78,0.0,inf,21687216,75326,0.35,Europe
Rwanda,133090,1468,0,131622,0,0,0,1.1,0.0,inf,133090,0,0.0,Africa
Saint Kitts and Nevis,6593,46,0,6547,0,0,0,0.7,0.0,inf,6592,1,0.02,Americas
Saint Lucia,29882,409,0,29473,0,0,0,1.37,0.0,inf,29803,79,0.27,Americas
Saint Pierre and Miquelon (FR),3452,2,0,3450,0,0,0,0.06,0.0,inf,3452,0,0.0,Americas
Saint Vincent and the Grenadines,9587,123,0,9464,0,0,0,1.28,0.0,inf,9585,2,0.02,Americas
Samoa,16109,29,0,16080,0,0,0,0.18,0.0,inf,16087,22,0.14,Western Pacific
San Marino,23468,122,0,23346,0,0,0,0.52,0.0,inf,23427,41,0.18,Europe
Sao Tome and Principe,6280,77,0,6203,0,0,0,1.23,0.0,inf,6280,0,0.0,Africa
Saudi Arabia,828525,9592,0,818933,39,1,0,1.16,0.0,inf,828171,354,0.04,Eastern Mediterranean
Senegal,88902,1971,0,86931,0,0,0,2.22,0.0,inf,88902,0,0.0,Africa
Serbia,2479663,17739,0,2461924,933,6,0,0.72,0.0,inf,2474636,5027,0.2,Europe
Seychelles,50665,172,0,50493,0,0,0,0.34,0.0,inf,50665,0,0.0,Africa
Sierra Leone,7760,126,0,7634,0,0,0,1.62,0.0,inf,7760,0,0.0,Africa
Singapore,2222006,1722,0,2220284,244,0,0,0.08,0.0,inf,2219180,2826,0.13,Western Pacific
Sint Maarten (NL),11016,91,0,10925,0,0,0,0.83,0.0,inf,11014,2,0.02,Americas
Slovakia,2662318,20980,0,2641338,61,3,0,0.79,0.0,inf,2661315,1003,0.04,Europe
Slovenia,1323752,7064,0,1316688,65,0,0,0.53,0.0,inf,1322543,1209,0.09,Europe
Solomon Islands,24575,153,0,24422,0,0,0,0.62,0.0,inf,24575,0,0.0,Western Pacific
Somalia,27322,1361,0,25961,0,0,0,4.98,0.0,inf,27318,4,0.01,Eastern Mediterranean
South Africa,4057211,102595,0,3954616,0,0,0,2.53,0.0,inf,4056701,510,0.01,Africa
South Korea,30355373,33747,0,30321626,5174,11,0,0.11,0.0,inf,30263261,92112,0.3,Western Pacific
South Sudan,18368,138,0,18230,0,0,0,0.75,0.0,inf,18368,0,0.0,Africa
Spain,13748918,118976,0,13629942,0,0,0,0.87,0.0,inf,13740531,8387,0.06,Europe
Sri Lanka,672009,16829,0,655180,2,1,0,2.5,0.0,inf,672000,9,0.0,South-East Asia
Sudan,63759,5008,0,58751,0,0,0,7.85,0.0,inf,63754,5,0.01,Eastern Mediterranean
Summer Olympics 2020,865,0,0,865,0,0,0,0.0,0.0,0.0,865,0,0.0,
Suriname,82227,1400,0,80827,0,0,0,1.7,0.0,inf,82227,0,0.0,Americas
Sweden,2696168,23563,0,2672605,0,0,0,0.87,0.0,inf,2694893,1275,0.05,Europe
Switzerland,4408833,14211,0,4394622,0,0,0,0.32,0.0,inf,4407915,918,0.02,Europe
Syria,57453,3164,0,54289,0,0,0,5.51,0.0,inf,57453,0,0.0,Eastern Mediterranean
Taiwan*,9809098,17103,0,9791995,17190,57,0,0.17,0.0,inf,9668845,140253,1.45,Western Pacific
Tajikistan,17786,125,0,17661,0,0,0,0.7,0.0,inf,17786,0,0.0,Europe
Tanzania,42717,846,0,41871,0,0,0,1.98,0.0,inf,42664,53,0.12,Africa
Thailand,4727628,33894,0,4693734,392,12,0,0.72,0.0,inf,4727236,392,0.01,South-East Asia
Timor-Leste,23416,138,0,23278,0,0,0,0.59,0.0,inf,23415,1,0.0,South-East Asia
Togo,39362,290,0,39072,4,0,0,0.74,0.0,inf,39356,6,0.02,Africa
Tonga,16795,13,0,16782,0,0,0,0.08,0.0,inf,16779,16,0.1,Western Pacific
Trinidad and Tobago,188199,4331,0,183868,0,0,0,2.3,0.0,inf,187908,291,0.15,Americas
Tunisia,1150477,29312,0,1121165,0,0,0,2.55,0.0,inf,1150356,121,0.01,Eastern Mediterranean
Turkey,17042722,101492,0,16941230,0,0,0,0.6,0.0,inf,17042722,0,0.0,Europe
Turks and Caicos Islands (UK),6537,38,0,6499,0,0,0,0.58,0.0,inf,6537,0,0.0,Americas
Tuvalu,2805,0,0,2805,0,0,0,0.0,0.0,0.0,2805,0,0.0,Western Pacific
US,102849008,1114377,0,101734631,2469,6,0,1.08,0.0,inf,102602329,246679,0.24,Americas
Uganda,170400,3630,0,166770,0,0,0,2.13,0.0,inf,170400,0,0.0,Africa
Ukraine,5686987,119092,0,5567895,116,1,0,2.09,0.0,inf,5682632,4355,0.08,Europe
United Arab Emirates,1050402,2348,0,1048054,72,0,0,0.22,0.0,inf,1049828,574,0.05,Eastern Mediterranean
United Kingdom,24473981,218206,0,24255775,0,0,0,0.89,0.0,inf,24451691,22290,0.09,Europe
Uruguay,1033265,7614,0,1025651,0,0,0,0.74,0.0,inf,1032710,555,0.05,Americas
Uzbekistan,250743,1637,0,249106,0,0,0,0.65,0.0,inf,250622,121,0.05,Europe
Vanuatu,12014,14,0,12000,0,0,0,0.12,0.0,inf,12014,0,0.0,Western Pacific
Venezuela,551720,5851,0,545869,47,0,0,1.06,0.0,inf,551645,75,0.01,Americas
Vietnam,11526692,43186,0,11483506,41,0,0,0.37,0.0,inf,11526566,126,0.0,Western Pacific
West Bank and Gaza,703228,5708,0,697520,0,0,0,0.81,0.0,inf,703228,0,0.0,Eastern Mediterranean
Winter Olympics 2022,535,0,0,535,0,0,0,0.0,0.0,0.0,535,0,0.0,
Yemen,11945,2159,0,9786,0,0,0,18.07,0.0,inf,11945,0,0.0,Eastern Mediterranean
Zambia,342288,4051,0,338237,0,0,0,1.18,0.0,inf,341573,715,0.21,Africa
Zimbabwe,263083,5659,0,257424,0,0,0,2.15,0.0,inf,262324,759,0.29,Africa
