Country,Confirmed,Deaths,Recovered,Active,New cases,New deaths,New recovered,Deaths / 100 Cases,Recovered / 100 Cases,Deaths / 100 Recovered,Confirmed last week,1 week change,1 week % increase,WHO Region
Afghanistan,206414,7837,0,198577,83,2,0,3.8,0.0,inf,205907,507,0.25,Eastern Mediterranean
Albania,333472,3594,0,329878,17,0,0,1.08,0.0,inf,333343,129,0.04,Europe
Algeria,271128,6881,0,264247,6,0,0,2.54,0.0,inf,271090,38,0.01,Africa
Andorra,47446,158,0,47288,227,1,0,0.33,0.0,inf,47219,227,0.48,Europe
Angola,104808,1925,0,102883,58,0,0,1.84,0.0,inf,104676,132,0.13,Africa
Anguilla (UK),3904,12,0,3892,0,0,0,0.31,0.0,inf,3904,0,0.0,Americas
Antarctica,11,0,0,11,0,0,0,0.0,0.0,0.0,11,0,0.0,
Antigua and Barbuda,9106,146,0,8960,0,0,0,1.6,0.0,inf,9106,0,0.0,Americas
Argentina,9739856,130034,0,9609822,0,0,0,1.34,0.0,inf,9727247,12609,0.13,Americas
Armenia,445828,8712,0,437116,0,0,0,1.95,0.0,inf,445737,91,0.02,Europe
Aruba (NL),43693,280,0,43413,52,44,0,0.64,0.0,inf,43641,52,0.12,Americas
Australia,10767933,16304,0,10751629,4284,20,0,0.15,0.0,inf,10659898,108035,1.01,Western Pacific
Austria,5595286,21247,0,5574039,6818,5,0,0.38,0.0,inf,5561633,33653,0.61,Europe
Azerbaijan,824641,9984,0,814657,67,0,0,1.21,0.0,inf,824337,304,0.04,Europe
Bahamas,37491,833,0,36658,0,0,0,2.22,0.0,inf,37483,8,0.02,Americas
Bahrain,696851,1536,0,695315,0,0,0,0.22,0.0,inf,696332,519,0.07,Eastern Mediterranean
Bangladesh,2036717,29436,0,2007281,32,1,0,1.45,0.0,inf,2036585,132,0.01,South-East Asia
Barbados,104416,567,0,103849,0,0,0,0.54,0.0,inf,104416,0,0.0,Americas
Belarus,994037,7118,0,986919,0,0,0,0.72,0.0,inf,994037,0,0.0,Europe
Belgium,4644478,33086,0,4611392,0,0,0,0.71,0.0,inf,4639411,5067,0.11,Europe
Belize,69117,688,0,68429,0,0,0,1.0,0.0,inf,69048,69,0.1,Americas
Benin,27980,163,0,27817,0,0,0,0.58,0.0,inf,27980,0,0.0,Africa
Bhutan,62512,21,0,62491,0,0,0,0.03,0.0,inf,62503,9,0.01,South-East Asia
Bolivia,1114914,22252,0,1092662,1917,1,0,2.0,0.0,inf,1111086,3828,0.34,Americas
Bosnia and Herzegovina,400626,16208,0,384418,13,1,0,4.05,0.0,inf,400548,78,0.02,Europe
Botswana,326800,2793,0,324007,0,0,0,0.85,0.0,inf,326633,167,0.05,Africa
Brazil,35396191,690229,0,34705962,0,0,0,1.95,0.0,inf,35227599,168592,0.48,Americas
British Virgin Islands (UK),7305,64,0,7241,0,0,0,0.88,0.0,inf,7305,0,0.0,Americas
Brunei,261440,225,0,261215,3519,0,0,0.09,0.0,inf,257921,3519,1.36,Western Pacific
Bulgaria,1288400,38054,0,1250346,204,1,0,2.95,0.0,inf,1287256,1144,0.09,Europe
Burkina Faso,21631,387,0,21244,0,0,0,1.79,0.0,inf,21631,0,0.0,Africa
Burma,633369,19488,0,613881,28,0,0,3.08,0.0,inf,633245,124,0.02,South-East Asia
Burundi,51276,38,0,51238,258,0,0,0.07,0.0,inf,51018,258,0.51,Africa
Cabo Verde,63107,412,0,62695,12,0,0,0.65,0.0,inf,63037,70,0.11,Africa
Cambodia,138188,3056,0,135132,12,0,0,2.21,0.0,inf,138099,89,0.06,Western Pacific
Cameroon,123993,1965,0,122028,0,0,0,1.58,0.0,inf,123993,0,0.0,Africa
Canada,4455836,48348,0,4407488,2848,52,0,1.09,0.0,inf,4432413,23423,0.53,Americas
Cayman Islands (UK),31359,36,0,31323,0,0,0,0.11,0.0,inf,31359,0,0.0,Americas
Central African Republic,15311,113,0,15198,0,0,0,0.74,0.0,inf,15311,0,0.0,Africa
Chad,7647,194,0,7453,0,0,0,2.54,0.0,inf,7646,1,0.01,Africa
Chile,4945425,62605,0,4882820,4198,8,0,1.27,0.0,inf,4920010,25415,0.52,Americas
China,4004311,16105,0,3988206,37257,22,0,0.4,0.0,inf,3719252,285059,7.66,Western Pacific
Colombia,6317010,141881,0,6175129,2903,0,0,2.25,0.0,inf,6312657,4353,0.07,Americas
Comoros,8977,161,0,8816,0,0,0,1.79,0.0,inf,8965,12,0.13,Africa
Congo (Brazzaville),25375,386,0,24989,0,0,0,1.52,0.0,inf,25375,0,0.0,Africa
Congo (Kinshasa),94452,1456,0,92996,0,0,0,1.54,0.0,inf,94204,248,0.26,Africa
Costa Rica,1148914,9046,0,1139868,0,0,0,0.79,0.0,inf,1146135,2779,0.24,Americas
Cote d'Ivoire,87891,830,0,87061,1,0,0,0.94,0.0,inf,87885,6,0.01,Africa
Croatia,1255643,17371,0,1238272,488,7,0,1.38,0.0,inf,1253761,1882,0.15,Europe
Cuba,1111466,8530,0,1102936,14,0,0,0.77,0.0,inf,1111392,74,0.01,Americas
Curacao (NL),45986,297,0,45689,0,2,0,0.65,0.0,inf,45986,0,0.0,Americas
Cyprus,618248,1237,0,617011,0,0,0,0.2,0.0,inf,614237,4011,0.65,Europe
Czechia,4564148,41931,0,4522217,1261,8,0,0.92,0.0,inf,4558202,5946,0.13,Europe
Denmark,3360156,7557,0,3352599,0,0,0,0.22,0.0,inf,3353700,6456,0.19,Europe
Djibouti,15690,189,0,15501,0,0,0,1.2,0.0,inf,15690,0,0.0,Eastern Mediterranean
Dominica,15760,74,0,15686,0,0,0,0.47,0.0,inf,15760,0,0.0,Americas
Dominican Republic,650990,4384,0,646606,0,0,0,0.67,0.0,inf,650381,609,0.09,Americas
Ecuador,1013912,35940,0,977972,0,0,0,3.54,0.0,inf,1011132,2780,0.27,Americas
Egypt,515645,24799,0,490846,0,0,0,4.81,0.0,inf,515645,0,0.0,Eastern Mediterranean
El Salvador,201785,4230,0,197555,0,0,0,2.1,0.0,inf,201785,0,0.0,Americas
Equatorial Guinea,17184,183,0,17001,0,0,0,1.06,0.0,inf,17183,1,0.01,Africa
Eritrea,10189,103,0,10086,0,0,0,1.01,0.0,inf,10189,0,0.0,Africa
Estonia,609827,2799,0,607028,0,0,0,0.46,0.0,inf,609297,530,0.09,Europe
Eswatini,73908,1422,0,72486,0,0,0,1.92,0.0,inf,73770,138,0.19,Africa
Ethiopia,494926,7572,0,487354,69,0,0,1.53,0.0,inf,494578,348,0.07,Africa
Falkland Islands (Malvinas) (UK),1930,0,0,1930,0,0,0,0.0,0.0,0.0,1930,0,0.0,Africa
Faroe Islands (DK),34658,28,0,34630,0,0,0,0.08,0.0,inf,34658,0,0.0,Europe
Fiji,68451,878,0,67573,0,0,0,1.28,0.0,inf,68375,76,0.11,Western Pacific
Finland,1405255,7448,0,1397807,0,0,0,0.53,0.0,inf,1394254,11001,0.79,Europe
France,37338329,156278,0,37182051,75888,93,0,0.42,0.0,inf,36926877,411452,1.11,Europe
French Guiana,96389,411,0,95978,0,0,0,0.43,0.0,inf,95451,938,0.98,Americas
French Polynesia,77416,649,0,76767,141,0,0,0.84,0.0,inf,76985,431,0.56,Western Pacific
Gabon,48973,306,0,48667,0,0,0,0.62,0.0,inf,48973,0,0.0,Africa
Gambia,12586,372,0,12214,0,0,0,2.96,0.0,inf,12586,0,0.0,Africa
Georgia,1806918,16888,0,1790030,0,6,0,0.93,0.0,inf,1805698,1220,0.07,Europe
Germany,36690235,158684,0,36531551,40256,125,0,0.43,0.0,inf,36499600,190635,0.52,Europe
Ghana,171023,1461,0,169562,0,0,0,0.85,0.0,inf,171009,14,0.01,Africa
Gibraltar (UK),20207,110,0,20097,0,0,0,0.54,0.0,inf,20184,23,0.11,Europe
Greece,5448700,34482,0,5414218,0,0,0,0.63,0.0,inf,5404690,44010,0.81,Europe
Greenland (DK),11971,21,0,11950,0,0,0,0.18,0.0,inf,11971,0,0.0,Europe
Grenada,19636,237,0,19399,0,0,0,1.21,0.0,inf,19631,5,0.03,Americas
Guadeloupe (FR),197918,995,0,196923,0,0,0,0.5,0.0,inf,197918,0,0.0,Americas
Guatemala,1164240,19959,0,1144281,2257,1,0,1.71,0.0,inf,1156468,7772,0.67,Americas
Guinea,38153,464,0,37689,0,0,0,1.22,0.0,inf,38153,0,0.0,Africa
Guinea-Bissau,8848,176,0,8672,0,0,0,1.99,0.0,inf,8848,0,0.0,Africa
Guyana,71679,1285,0,70394,0,0,0,1.79,0.0,inf,71620,59,0.08,Americas
Haiti,33862,860,0,33002,0,0,0,2.54,0.0,inf,33846,16,0.05,Americas
Holy See,29,0,0,29,0,0,0,0.0,0.0,0.0,29,0,0.0,Europe
Honduras,458921,11051,0,447870,0,0,0,2.41,0.0,inf,458023,898,0.2,Americas
Hungary,2171056,48337,0,2122719,4704,50,0,2.23,0.0,inf,2166352,4704,0.22,Europe
Iceland,207101,219,0,206882,0,0,0,0.11,0.0,inf,207101,0,0.0,Europe
India,44675413,530647,0,44144766,241,9,0,1.19,0.0,inf,44673863,1550,0.0,South-East Asia
Indonesia,6689532,160112,0,6529420,3351,41,0,2.39,0.0,inf,6664844,24688,0.37,South-East Asia
Iran,7559999,144649,0,7415350,41,1,0,1.91,0.0,inf,7559706,293,0.0,Eastern Mediterranean
Iraq,2464375,25366,0,2439009,0,0,0,1.03,0.0,inf,2463724,651,0.03,Eastern Mediterranean
Ireland,1682409,8231,0,1674178,1861,34,0,0.49,0.0,inf,1680548,1861,0.11,Europe
Israel,4733452,11905,0,4721547,2959,23,0,0.25,0.0,inf,4722410,11042,0.23,Europe
Italy,24488080,181733,0,24306347,0,0,0,0.74,0.0,inf,24260660,227420,0.94,Europe
Jamaica,152624,3433,0,149191,107,34,0,2.25,0.0,inf,152517,107,0.07,Americas
Japan,25576875,50827,0,25526048,149383,211,0,0.2,0.0,inf,24815308,761567,3.07,Western Pacific
Jordan,1746997,14122,0,1732875,0,0,0,0.81,0.0,inf,1746997,0,0.0,Eastern Mediterranean
Kazakhstan,1487167,19054,0,1468113,0,0,0,1.28,0.0,inf,1485635,1532,0.1,Europe
Kenya,342026,5684,0,336342,49,0,0,1.66,0.0,inf,341636,390,0.11,Africa
Kiribati,3430,13,0,3417,0,0,0,0.38,0.0,inf,3430,0,0.0,Western Pacific
"Korea, North",1,6,0,-5,0,0,0,600.0,0.0,inf,1,0,0.0,
Kosovo,272216,3202,0,269014,2,0,0,1.18,0.0,inf,272209,7,0.0,Europe
Kuwait,662747,2570,0,660177,0,0,0,0.39,0.0,inf,662672,75,0.01,Eastern Mediterranean
Kyrgyzstan,206543,2991,0,203552,0,0,0,1.45,0.0,inf,206530,13,0.01,Europe
Laos,217026,758,0,216268,38,0,0,0.35,0.0,inf,216744,282,0.13,Western Pacific
Latvia,966813,6107,0,960706,682,2,0,0.63,0.0,inf,963451,3362,0.35,Europe
Lebanon,1220831,10740,0,1210091,31,0,0,0.88,0.0,inf,1220560,271,0.02,Eastern Mediterranean
Lesotho,34490,706,0,33784,0,0,0,2.05,0.0,inf,34490,0,0.0,Africa
Liberia,8035,294,0,7741,0,0,0,3.66,0.0,inf,8022,13,0.16,Africa
Libya,507100,6437,0,500663,0,0,0,1.27,0.0,inf,507084,16,0.0,Eastern Mediterranean
Liechtenstein,21064,88,0,20976,22,0,0,0.42,0.0,inf,20935,129,0.62,Europe
Lithuania,1279048,9442,0,1269606,590,3,0,0.74,0.0,inf,1276076,2972,0.23,Europe
Luxembourg,308061,1168,0,306893,248,0,0,0.38,0.0,inf,306843,1218,0.4,Europe
Madagascar,67488,1413,0,66075,0,0,0,2.09,0.0,inf,67259,229,0.34,Africa
Malawi,88220,2685,0,85535,134,0,0,3.04,0.0,inf,88086,134,0.15,Africa
Malaysia,5005239,36738,0,4968501,1682,6,0,0.73,0.0,inf,4992168,13071,0.26,Western Pacific
Maldives,185632,311,0,185321,0,0,0,0.17,0.0,inf,185618,14,0.01,South-East Asia
Mali,32760,742,0,32018,0,0,0,2.26,0.0,inf,32760,0,0.0,Africa
Malta,115918,809,0,115109,11,0,0,0.7,0.0,inf,115818,100,0.09,Europe
Marshall Islands,15541,17,0,15524,0,0,0,0.11,0.0,inf,15541,0,0.0,Western Pacific
Martinique (FR),224468,1071,0,223397,0,0,0,0.48,0.0,inf,224468,0,0.0,Americas
Mauritania,63421,997,0,62424,0,0,0,1.57,0.0,inf,63420,1,0.0,Africa
Mauritius,281163,1036,0,280127,0,0,0,0.37,0.0,inf,276456,4707,1.7,Africa
Mayotte (FR),41679,187,0,41492,0,0,0,0.45,0.0,inf,41176,503,1.22,Africa
Mexico,7152852,330633,0,6822219,3966,31,0,4.62,0.0,inf,7125176,27676,0.39,Americas
Micronesia,22203,58,0,22145,0,0,0,0.26,0.0,inf,22203,0,0.0,Western Pacific
Moldova,595402,11920,0,583482,0,0,0,2.0,0.0,inf,595073,329,0.06,Europe
Monaco,15674,65,0,15609,31,0,0,0.41,0.0,inf,15442,232,1.5,Europe
Mongolia,993779,2135,0,991644,74,0,0,0.21,0.0,inf,992767,1012,0.1,Western Pacific
Montenegro,283942,2790,0,281152,47,0,0,0.98,0.0,inf,283719,223,0.08,Europe
Montserrat (UK),1403,8,0,1395,0,0,0,0.57,0.0,inf,1403,0,0.0,Americas
Morocco,1269717,16287,0,1253430,147,1,0,1.28,0.0,inf,1268823,894,0.07,Eastern Mediterranean
Mozambique,230624,2226,0,228398,0,0,0,0.97,0.0,inf,230624,0,0.0,Africa
Namibia,169946,4080,0,165866,0,0,0,2.4,0.0,inf,169946,0,0.0,Africa
Nauru,4621,1,0,4620,0,0,0,0.02,0.0,inf,4621,0,0.0,Western Pacific
Nepal,1000921,12019,0,988902,9,0,0,1.2,0.0,inf,1000889,32,0.0,South-East Asia
Netherlands,8547284,22927,0,8524357,0,0,0,0.27,0.0,inf,8541865,5419,0.06,Europe
New Zealand,1986183,2236,0,1983947,0,0,0,0.11,0.0,inf,1951642,34541,1.77,Western Pacific
Nicaragua,15263,245,0,15018,13,0,0,1.61,0.0,inf,15250,13,0.09,Americas
Niger,9434,314,0,9120,0,0,0,3.33,0.0,inf,9434,0,0.0,Africa
Nigeria,266283,3155,0,263128,0,0,0,1.18,0.0,inf,266283,0,0.0,Africa
North Macedonia,345067,9591,0,335476,0,0,0,2.78,0.0,inf,344710,357,0.1,Europe
Norway,1470201,4439,0,1465762,218,0,0,0.3,0.0,inf,1469061,1140,0.08,Europe
Oman,399119,4628,0,394491,0,0,0,1.16,0.0,inf,399119,0,0.0,Eastern Mediterranean
Pakistan,1575406,30634,0,1544772,24,0,0,1.94,0.0,inf,1575225,181,0.01,Eastern Mediterranean
Palau,5896,7,0,5889,0,0,0,0.12,0.0,inf,5785,111,1.92,Western Pacific
Panama,1009252,8533,0,1000719,0,0,0,0.85,0.0,inf,1002161,7091,0.71,Americas
Papua New Guinea,46338,668,0,45670,91,0,0,1.44,0.0,inf,46146,192,0.42,Western Pacific
Paraguay,778895,19646,0,759249,1370,16,0,2.52,0.0,inf,718164,60731,8.46,Americas
Peru,4330521,217566,0,4112955,30215,24,0,5.02,0.0,inf,4252383,78138,1.84,Americas
Philippines,4044000,64794,0,3979206,1064,24,0,1.6,0.0,inf,4036277,7723,0.19,Western Pacific
Poland,6356082,118350,0,6237732,658,3,0,1.86,0.0,inf,6352755,3327,0.05,Europe
Portugal,5546290,25517,0,5520773,0,0,0,0.46,0.0,inf,5542265,4025,0.07,Europe
Qatar,482499,685,0,481814,595,0,0,0.14,0.0,inf,478848,3651,0.76,Eastern Mediterranean
Reunion (FR),481540,903,0,480637,0,0,0,0.19,0.0,inf,480323,1217,0.25,Africa
Romania,3298738,67289,0,3231449,0,0,0,2.04,0.0,inf,3296834,1904,0.06,Europe
Russia,21329068,384494,0,20944574,6900,57,0,1.8,0.0,inf,21284476,44592,0.21,Europe
Rwanda,132811,1467,0,131344,0,0,0,1.1,0.0,inf,132762,49,0.04,Africa
Saint Kitts and Nevis,6559,46,0,6513,0,0,0,0.7,0.0,inf,6556,3,0.05,Americas
Saint Lucia,29723,409,0,29314,0,0,0,1.38,0.0,inf,29711,12,0.04,Americas
Saint Pierre and Miquelon (FR),3282,1,0,3281,0,0,0,0.03,0.0,inf,3250,32,0.98,Americas
Saint Vincent and the Grenadines,9474,116,0,9358,0,0,0,1.22,0.0,inf,9474,0,0.0,Americas
Samoa,15968,29,0,15939,0,0,0,0.18,0.0,inf,15967,1,0.01,Western Pacific
San Marino,22406,119,0,22287,0,0,0,0.53,0.0,inf,22167,239,1.08,Europe
Sao Tome and Principe,6279,77,0,6202,0,0,0,1.23,0.0,inf,6278,1,0.02,Africa
Saudi Arabia,826009,9477,0,816532,73,1,0,1.15,0.0,inf,825597,412,0.05,Eastern Mediterranean
Senegal,88887,1968,0,86919,0,0,0,2.21,0.0,inf,88873,14,0.02,Africa
Serbia,2427599,17420,0,2410179,751,2,0,0.72,0.0,inf,2423385,4214,0.17,Europe
Seychelles,50068,171,0,49897,0,0,0,0.34,0.0,inf,50068,0,0.0,Africa
Sierra Leone,7760,126,0,7634,0,0,0,1.62,0.0,inf,7759,1,0.01,Africa
Singapore,2176338,1707,0,2174631,1349,1,0,0.08,0.0,inf,2167897,8441,0.39,Western Pacific
Sint Maarten (NL),10964,89,0,10875,0,0,0,0.81,0.0,inf,10954,10,0.09,Americas
Slovakia,2651788,20747,0,2631041,329,2,0,0.78,0.0,inf,2650230,1558,0.06,Europe
Slovenia,1269058,6945,0,1262113,2307,1,0,0.55,0.0,inf,1258446,10612,0.84,Europe
Solomon Islands,24575,153,0,24422,0,0,0,0.62,0.0,inf,24575,0,0.0,Western Pacific
Somalia,27286,1361,0,25925,0,0,0,4.99,0.0,inf,27286,0,0.0,Eastern Mediterranean
South Africa,4043543,102464,0,3941079,301,0,0,2.53,0.0,inf,4041890,1653,0.04,Africa
South Korea,27548821,30908,0,27517913,65253,61,0,0.11,0.0,inf,27155813,393008,1.45,Western Pacific
South Sudan,18352,138,0,18214,0,0,0,0.75,0.0,inf,18350,2,0.01,Africa
Spain,13614807,116108,0,13498699,0,0,0,0.85,0.0,inf,13595504,19303,0.14,Europe
Sri Lanka,671722,16806,0,654916,3,0,0,2.5,0.0,inf,671682,40,0.01,South-East Asia
Sudan,63655,4991,0,58664,0,0,0,7.84,0.0,inf,63637,18,0.03,Eastern Mediterranean
Summer Olympics 2020,865,0,0,865,0,0,0,0.0,0.0,0.0,865,0,0.0,
Suriname,81581,1393,0,80188,0,0,0,1.71,0.0,inf,81581,0,0.0,Americas
Sweden,2632091,21127,0,2610964,0,0,0,0.8,0.0,inf,2626686,5405,0.21,Europe
Switzerland,4356582,14147,0,4342435,0,5,0,0.32,0.0,inf,4337983,18599,0.43,Europe
Syria,57410,3163,0,54247,1,0,0,5.51,0.0,inf,57399,11,0.02,Eastern Mediterranean
Taiwan*,8412200,14548,0,8397652,16723,26,0,0.17,0.0,inf,8313366,98834,1.19,Western Pacific
Tajikistan,17786,125,0,17661,0,0,0,0.7,0.0,inf,17786,0,0.0,Europe
Tanzania,40806,845,0,39961,0,0,0,2.07,0.0,inf,40656,150,0.37,Africa
Thailand,4711528,33285,0,4678243,0,0,0,0.71,0.0,inf,4707244,4284,0.09,South-East Asia
Timor-Leste,23360,138,0,23222,5,0,0,0.59,0.0,inf,23343,17,0.07,South-East Asia
Togo,39334,290,0,39044,2,0,0,0.74,0.0,inf,39328,6,0.02,Africa
Tonga,16182,12,0,16170,0,0,0,0.07,0.0,inf,16182,0,0.0,Western Pacific
Trinidad and Tobago,185528,4268,0,181260,0,0,0,2.3,0.0,inf,185377,151,0.08,Americas
Tunisia,1147145,29269,0,1117876,0,0,0,2.55,0.0,inf,1147072,73,0.01,Eastern Mediterranean
Turkey,16919638,101203,0,16818435,0,0,0,0.6,0.0,inf,16919638,0,0.0,Europe
Turks and Caicos Islands (UK),6446,36,0,6410,0,0,0,0.56,0.0,inf,6446,0,0.0,Americas
Tuvalu,2805,0,0,2805,0,0,0,0.0,0.0,0.0,2805,0,0.0,Western Pacific
US,99230740,1083362,0,98147378,142748,1037,0,1.09,0.0,inf,98813999,416741,0.42,Americas
Uganda,169810,3630,0,166180,0,0,0,2.14,0.0,inf,169733,77,0.05,Africa
Ukraine,5647980,118492,0,5529488,35,1,0,2.1,0.0,inf,5642645,5335,0.09,Europe
United Arab Emirates,1045040,2348,0,1042692,106,0,0,0.22,0.0,inf,1044343,697,0.07,Eastern Mediterranean
United Kingdom,24177481,212772,0,23964709,180,1,0,0.88,0.0,inf,24150369,27112,0.11,Europe
Uruguay,995402,7541,0,987861,0,0,0,0.76,0.0,inf,993875,1527,0.15,Americas
Uzbekistan,247581,1637,0,245944,157,0,0,0.66,0.0,inf,246520,1061,0.43,Europe
Vanuatu,11981,14,0,11967,0,0,0,0.12,0.0,inf,11981,0,0.0,Western Pacific
Venezuela,547962,5829,0,542133,71,0,0,1.06,0.0,inf,547396,566,0.1,Americas
Vietnam,11519011,43178,0,11475833,500,0,0,0.37,0.0,inf,11515908,3103,0.03,Western Pacific
West Bank and Gaza,703036,5708,0,697328,0,0,0,0.81,0.0,inf,703036,0,0.0,Eastern Mediterranean
Winter Olympics 2022,535,0,0,535,0,0,0,0.0,0.0,0.0,535,0,0.0,
Yemen,11945,2159,0,9786,0,0,0,18.07,0.0,inf,11945,0,0.0,Eastern Mediterranean
Zambia,333746,4019,0,329727,0,0,0,1.2,0.0,inf,333746,0,0.0,Africa
Zimbabwe,259356,5622,0,253734,0,0,0,2.17,0.0,inf,259164,192,0.07,Africa
