Country,Confirmed,Deaths,Recovered,Active,New cases,New deaths,New recovered,Deaths / 100 Cases,Recovered / 100 Cases,Deaths / 100 Recovered,Confirmed last week,1 week change,1 week % increase,WHO Region
Afghanistan,182072,7717,0,174355,39,0,0,4.24,0.0,inf,181574,498,0.27,Eastern Mediterranean
Albania,278793,3497,0,275296,289,0,0,1.25,0.0,inf,277141,1652,0.6,Europe
Algeria,266030,6875,0,259155,5,0,0,2.58,0.0,inf,265971,59,0.02,Africa
Andorra,43774,153,0,43621,0,0,0,0.35,0.0,inf,43449,325,0.75,Europe
Angola,99761,1900,0,97861,0,0,0,1.9,0.0,inf,99761,0,0.0,Africa
Anguilla (UK),3411,9,0,3402,0,0,0,0.26,0.0,inf,3374,37,1.1,Americas
Antarctica,11,0,0,11,0,0,0,0.0,0.0,0.0,11,0,0.0,
Antigua and Barbuda,8625,141,0,8484,0,0,0,1.63,0.0,inf,8581,44,0.51,Americas
Argentina,9341492,129016,0,9212476,0,0,0,1.38,0.0,inf,9313453,28039,0.3,Americas
Armenia,423104,8629,0,414475,0,0,0,2.04,0.0,inf,423044,60,0.01,Europe
Aruba (NL),40595,221,0,40374,416,0,0,0.54,0.0,inf,39980,615,1.54,Americas
Australia,8000312,9682,0,7990630,21437,27,0,0.12,0.0,inf,7801241,199071,2.55,Western Pacific
Austria,4400566,20015,0,4380551,0,0,0,0.45,0.0,inf,4349916,50650,1.16,Europe
Azerbaijan,793140,9717,0,783423,34,0,0,1.23,0.0,inf,792985,155,0.02,Europe
Bahamas,35814,816,0,34998,4,0,0,2.28,0.0,inf,35603,211,0.59,Americas
Bahrain,616588,1492,0,615096,1463,0,0,0.24,0.0,inf,603848,12740,2.11,Eastern Mediterranean
Bangladesh,1963493,29138,0,1934355,1280,3,0,1.48,0.0,inf,1955731,7762,0.4,South-East Asia
Barbados,83663,473,0,83190,139,0,0,0.57,0.0,inf,82826,837,1.01,Americas
Belarus,982867,6978,0,975889,0,0,0,0.71,0.0,inf,982867,0,0.0,Europe
Belgium,4211511,31883,0,4179628,0,0,0,0.76,0.0,inf,4187940,23571,0.56,Europe
Belize,63037,679,0,62358,0,0,0,1.08,0.0,inf,61918,1119,1.81,Americas
Benin,27122,163,0,26959,0,0,0,0.6,0.0,inf,27122,0,0.0,Africa
Bhutan,59674,21,0,59653,0,0,0,0.04,0.0,inf,59644,30,0.05,South-East Asia
Bolivia,920595,21953,0,898642,858,1,0,2.38,0.0,inf,914827,5768,0.63,Americas
Bosnia and Herzegovina,378413,15799,0,362614,0,0,0,4.18,0.0,inf,378209,204,0.05,Europe
Botswana,318528,2719,0,315809,0,0,0,0.85,0.0,inf,314242,4286,1.36,Africa
Brazil,32023166,670229,0,31352937,0,0,0,2.09,0.0,inf,31611769,411397,1.3,Americas
British Virgin Islands (UK),6941,63,0,6878,0,0,0,0.91,0.0,inf,6941,0,0.0,Americas
Brunei,159591,225,0,159366,0,0,0,0.14,0.0,inf,156452,3139,2.01,Western Pacific
Bulgaria,1169968,37246,0,1132722,240,0,0,3.18,0.0,inf,1168035,1933,0.17,Europe
Burkina Faso,21044,387,0,20657,0,0,0,1.84,0.0,inf,21044,0,0.0,Africa
Burma,613553,19434,0,594119,15,0,0,3.17,0.0,inf,613485,68,0.01,South-East Asia
Burundi,42542,38,0,42504,0,0,0,0.09,0.0,inf,42398,144,0.34,Africa
Cabo Verde,59265,403,0,58862,0,0,0,0.68,0.0,inf,58029,1236,2.13,Africa
Cambodia,136262,3056,0,133206,0,0,0,2.24,0.0,inf,136262,0,0.0,Western Pacific
Cameroon,120002,1930,0,118072,0,0,0,1.61,0.0,inf,119947,55,0.05,Africa
Canada,3940490,41875,0,3898615,896,1,0,1.06,0.0,inf,3925875,14615,0.37,Americas
Cayman Islands (UK),27171,28,0,27143,374,0,0,0.1,0.0,inf,26797,374,1.4,Americas
Central African Republic,14649,113,0,14536,0,0,0,0.77,0.0,inf,14649,0,0.0,Africa
Chad,7424,193,0,7231,0,0,0,2.6,0.0,inf,7420,4,0.05,Africa
Chile,3948012,58385,0,3889627,12637,39,0,1.48,0.0,inf,3882425,65587,1.69,Americas
China,2124209,14624,0,2109585,1926,0,0,0.69,0.0,inf,2112692,11517,0.55,Western Pacific
Colombia,6151354,139970,0,6011384,0,0,0,2.28,0.0,inf,6131657,19697,0.32,Americas
Comoros,8136,160,0,7976,0,0,0,1.97,0.0,inf,8131,5,0.06,Africa
Congo (Brazzaville),24128,385,0,23743,0,0,0,1.6,0.0,inf,24128,0,0.0,Africa
Congo (Kinshasa),91082,1371,0,89711,0,0,0,1.51,0.0,inf,89932,1150,1.28,Africa
Costa Rica,904934,8525,0,896409,0,0,0,0.94,0.0,inf,904934,0,0.0,Americas
Cote d'Ivoire,82999,805,0,82194,46,1,0,0.97,0.0,inf,82659,340,0.41,Africa
Croatia,1145053,16048,0,1129005,1087,1,0,1.4,0.0,inf,1141546,3507,0.31,Europe
Cuba,1105896,8529,0,1097367,21,0,0,0.77,0.0,inf,1105729,167,0.02,Americas
Curacao (NL),44440,278,0,44162,0,0,0,0.63,0.0,inf,44314,126,0.28,Americas
Cyprus,504717,1072,0,503645,0,0,0,0.21,0.0,inf,497454,7263,1.46,Europe
Czechia,3929036,40313,0,3888723,239,0,0,1.03,0.0,inf,3925291,3745,0.1,Europe
Denmark,3161148,6438,0,3154710,0,0,0,0.2,0.0,inf,3150599,10549,0.33,Europe
Djibouti,15690,189,0,15501,0,0,0,1.2,0.0,inf,15690,0,0.0,Eastern Mediterranean
Dominica,14821,67,0,14754,0,0,0,0.45,0.0,inf,14781,40,0.27,Americas
Dominican Republic,600410,4383,0,596027,0,0,0,0.73,0.0,inf,595927,4483,0.75,Americas
Ecuador,901739,35705,0,866034,3072,10,0,3.96,0.0,inf,896483,5256,0.59,Americas
Egypt,515645,24722,0,490923,0,0,0,4.79,0.0,inf,515645,0,0.0,Eastern Mediterranean
El Salvador,169646,4139,0,165507,0,0,0,2.44,0.0,inf,164134,5512,3.36,Americas
Equatorial Guinea,15995,183,0,15812,0,0,0,1.14,0.0,inf,15951,44,0.28,Africa
Eritrea,9788,103,0,9685,0,0,0,1.05,0.0,inf,9777,11,0.11,Africa
Estonia,579316,2588,0,576728,0,0,0,0.45,0.0,inf,578494,822,0.14,Europe
Eswatini,73071,1415,0,71656,2,0,0,1.94,0.0,inf,73003,68,0.09,Africa
Ethiopia,487217,7530,0,479687,386,3,0,1.55,0.0,inf,483739,3478,0.72,Africa
Falkland Islands (Malvinas) (UK),1807,0,0,1807,0,0,0,0.0,0.0,0.0,1756,51,2.9,Africa
Faroe Islands (DK),34658,28,0,34630,0,0,0,0.08,0.0,inf,34658,0,0.0,Europe
Fiji,65465,865,0,64600,0,0,0,1.32,0.0,inf,65268,197,0.3,Western Pacific
Finland,1133597,4832,0,1128765,0,0,0,0.43,0.0,inf,1125342,8255,0.73,Europe
France,29738074,146405,0,29591669,0,0,0,0.49,0.0,inf,29315828,422246,1.44,Europe
French Guiana,85596,400,0,85196,0,0,0,0.47,0.0,inf,84507,1089,1.29,Americas
French Polynesia,73234,649,0,72585,0,0,0,0.89,0.0,inf,73142,92,0.13,Western Pacific
Gabon,47824,305,0,47519,0,0,0,0.64,0.0,inf,47742,82,0.17,Africa
Gambia,12002,365,0,11637,0,0,0,3.04,0.0,inf,12002,0,0.0,Africa
Georgia,1659371,16839,0,1642532,0,0,0,1.01,0.0,inf,1658755,616,0.04,Europe
Germany,27771112,140734,0,27630378,1,0,0,0.51,0.0,inf,27204955,566157,2.08,Europe
Ghana,164843,1448,0,163395,0,0,0,0.88,0.0,inf,163332,1511,0.93,Africa
Gibraltar (UK),19306,104,0,19202,0,0,0,0.54,0.0,inf,19010,296,1.56,Europe
Greece,3607580,30162,0,3577418,12082,8,0,0.84,0.0,inf,3539423,68157,1.93,Europe
Greenland (DK),11971,21,0,11950,0,0,0,0.18,0.0,inf,11971,0,0.0,Europe
Grenada,18270,232,0,18038,27,0,0,1.27,0.0,inf,18115,155,0.86,Americas
Guadeloupe (FR),166424,950,0,165474,0,0,0,0.57,0.0,inf,164325,2099,1.28,Americas
Guatemala,896133,18491,0,877642,3062,22,0,2.06,0.0,inf,880169,15964,1.81,Americas
Guinea,36817,442,0,36375,0,0,0,1.2,0.0,inf,36817,0,0.0,Africa
Guinea-Bissau,8348,171,0,8177,0,0,0,2.05,0.0,inf,8307,41,0.49,Africa
Guyana,67058,1251,0,65807,111,2,0,1.87,0.0,inf,66456,602,0.91,Americas
Haiti,31301,837,0,30464,53,0,0,2.67,0.0,inf,31054,247,0.8,Americas
Holy See,29,0,0,29,0,0,0,0.0,0.0,0.0,29,0,0.0,Europe
Honduras,426490,10904,0,415586,0,0,0,2.56,0.0,inf,426095,395,0.09,Americas
Hungary,1925083,46626,0,1878457,0,0,0,2.42,0.0,inf,1923122,1961,0.1,Europe
Iceland,192991,153,0,192838,0,0,0,0.08,0.0,inf,191079,1912,1.0,Europe
India,43389973,524999,0,42864974,11739,25,0,1.21,0.0,inf,43296692,93281,0.22,South-East Asia
Indonesia,6078725,156714,0,5922011,1831,3,0,2.58,0.0,inf,6066908,11817,0.19,South-East Asia
Iran,7236064,141383,0,7094681,136,4,0,1.95,0.0,inf,7234597,1467,0.02,Eastern Mediterranean
Iraq,2338109,25229,0,2312880,1345,0,0,1.08,0.0,inf,2331872,6237,0.27,Eastern Mediterranean
Ireland,1587385,7469,0,1579916,0,0,0,0.47,0.0,inf,1578284,9101,0.58,Europe
Israel,4293073,10926,0,4282147,6950,5,0,0.25,0.0,inf,4226245,66828,1.58,Europe
Italy,18184917,168058,0,18016859,56873,40,0,0.92,0.0,inf,17844905,340012,1.91,Europe
Jamaica,142161,3112,0,139049,0,0,0,2.19,0.0,inf,141306,855,0.61,Americas
Japan,9227180,31113,0,9196067,16573,9,0,0.34,0.0,inf,9124454,102726,1.13,Western Pacific
Jordan,1698316,14068,0,1684248,0,0,0,0.83,0.0,inf,1697673,643,0.04,Eastern Mediterranean
Kazakhstan,1395399,19018,0,1376381,62,0,0,1.36,0.0,inf,1395148,251,0.02,Europe
Kenya,331966,5651,0,326315,427,0,0,1.7,0.0,inf,329107,2859,0.87,Africa
Kiribati,3236,13,0,3223,0,0,0,0.4,0.0,inf,3215,21,0.65,Western Pacific
"Korea, North",1,6,0,-5,0,0,0,600.0,0.0,inf,1,0,0.0,
Kosovo,228673,3140,0,225533,0,0,0,1.37,0.0,inf,228523,150,0.07,Europe
Kuwait,641985,2555,0,639430,307,0,0,0.4,0.0,inf,638708,3277,0.51,Eastern Mediterranean
Kyrgyzstan,201024,2991,0,198033,0,0,0,1.49,0.0,inf,201016,8,0.0,Europe
Laos,210238,757,0,209481,5,0,0,0.36,0.0,inf,210194,44,0.02,Western Pacific
Latvia,832884,5855,0,827029,0,0,0,0.7,0.0,inf,831727,1157,0.14,Europe
Lebanon,1107602,10460,0,1097142,836,2,0,0.94,0.0,inf,1103264,4338,0.39,Eastern Mediterranean
Lesotho,33938,699,0,33239,0,0,0,2.06,0.0,inf,33746,192,0.57,Africa
Liberia,7493,294,0,7199,0,0,0,3.92,0.0,inf,7489,4,0.05,Africa
Libya,502110,6430,0,495680,0,0,0,1.28,0.0,inf,502076,34,0.01,Eastern Mediterranean
Liechtenstein,17814,85,0,17729,0,0,0,0.48,0.0,inf,17653,161,0.91,Europe
Lithuania,1159450,9163,0,1150287,93097,0,0,0.79,0.0,inf,1065134,94316,8.85,Europe
Luxembourg,258467,1088,0,257379,0,0,0,0.42,0.0,inf,254865,3602,1.41,Europe
Madagascar,65009,1398,0,63611,0,0,0,2.15,0.0,inf,64685,324,0.5,Africa
Malawi,86348,2645,0,83703,0,0,0,3.06,0.0,inf,86202,146,0.17,Africa
Malaysia,4554661,35745,0,4518916,2302,0,0,0.78,0.0,inf,4538922,15739,0.35,Western Pacific
Maldives,180384,300,0,180084,0,0,0,0.17,0.0,inf,179979,405,0.23,South-East Asia
Mali,31153,737,0,30416,3,1,0,2.37,0.0,inf,31137,16,0.05,Africa
Malta,100594,740,0,99854,456,0,0,0.74,0.0,inf,97557,3037,3.11,Europe
Marshall Islands,18,0,0,18,0,0,0,0.0,0.0,0.0,18,0,0.0,Western Pacific
Martinique (FR),188959,957,0,188002,0,0,0,0.51,0.0,inf,180883,8076,4.46,Americas
Mauritania,59428,982,0,58446,27,0,0,1.65,0.0,inf,59293,135,0.23,Africa
Mauritius,229479,1002,0,228477,0,0,0,0.44,0.0,inf,227442,2037,0.9,Africa
Mayotte (FR),37877,187,0,37690,0,0,0,0.49,0.0,inf,37820,57,0.15,Africa
Mexico,5956732,325576,0,5631156,33646,65,0,5.47,0.0,inf,5852596,104136,1.78,Americas
Micronesia,38,0,0,38,0,0,0,0.0,0.0,0.0,38,0,0.0,Western Pacific
Moldova,519741,11563,0,508178,0,0,0,2.22,0.0,inf,519452,289,0.06,Europe
Monaco,12808,57,0,12751,39,0,0,0.45,0.0,inf,12616,192,1.52,Europe
Mongolia,926282,2179,0,924103,0,0,0,0.24,0.0,inf,926282,0,0.0,Western Pacific
Montenegro,239291,2724,0,236567,184,0,0,1.14,0.0,inf,238416,875,0.37,Europe
Montserrat (UK),1016,8,0,1008,0,0,0,0.79,0.0,inf,1015,1,0.1,Americas
Morocco,1202461,16098,0,1186363,3235,1,0,1.34,0.0,inf,1184732,17729,1.5,Eastern Mediterranean
Mozambique,227616,2212,0,225404,89,0,0,0.97,0.0,inf,227083,533,0.23,Africa
Namibia,169076,4061,0,165015,69,3,0,2.4,0.0,inf,168851,225,0.13,Africa
Nepal,979512,11952,0,967560,23,0,0,1.22,0.0,inf,979344,168,0.02,South-East Asia
Netherlands,8152685,22354,0,8130331,0,0,0,0.27,0.0,inf,8122170,30515,0.38,Europe
New Zealand,1314155,1411,0,1312744,4608,6,0,0.11,0.0,inf,1279116,35039,2.74,Western Pacific
Nicaragua,14619,241,0,14378,0,0,0,1.65,0.0,inf,14619,0,0.0,Americas
Niger,9031,310,0,8721,0,0,0,3.43,0.0,inf,9031,0,0.0,Africa
Nigeria,256958,3144,0,253814,247,0,0,1.22,0.0,inf,256573,385,0.15,Africa
North Macedonia,313360,9322,0,304038,0,0,0,2.97,0.0,inf,312879,481,0.15,Europe
Norway,1444043,3280,0,1440763,406,0,0,0.23,0.0,inf,1439656,4387,0.3,Europe
Oman,390244,4628,0,385616,0,0,0,1.19,0.0,inf,389758,486,0.12,Eastern Mediterranean
Pakistan,1533482,30386,0,1503096,0,0,0,1.98,0.0,inf,1531982,1500,0.1,Eastern Mediterranean
Palau,5201,6,0,5195,0,0,0,0.12,0.0,inf,5181,20,0.39,Western Pacific
Panama,913932,8346,0,905586,1584,6,0,0.91,0.0,inf,902386,11546,1.28,Americas
Papua New Guinea,44702,662,0,44040,0,0,0,1.48,0.0,inf,44681,21,0.05,Western Pacific
Paraguay,655532,18963,0,636569,0,0,0,2.89,0.0,inf,653428,2104,0.32,Americas
Peru,3611123,213443,0,3397680,0,0,0,5.91,0.0,inf,3597866,13257,0.37,Americas
Philippines,3700028,60507,0,3639521,777,0,0,1.64,0.0,inf,3695652,4376,0.12,Western Pacific
Poland,6012979,116417,0,5896562,344,5,0,1.94,0.0,inf,6011174,1805,0.03,Europe
Portugal,5120970,24013,0,5096957,0,0,0,0.47,0.0,inf,5005783,115187,2.3,Europe
Qatar,379277,678,0,378599,459,0,0,0.18,0.0,inf,374923,4354,1.16,Eastern Mediterranean
Reunion (FR),421269,807,0,420462,0,0,0,0.19,0.0,inf,419968,1301,0.31,Africa
Romania,2915487,65726,0,2849761,0,0,0,2.25,0.0,inf,2912878,2609,0.09,Europe
Russia,18147044,373134,0,17773910,3037,59,0,2.06,0.0,inf,18126576,20468,0.11,Europe
Rwanda,130787,1459,0,129328,38,0,0,1.12,0.0,inf,130531,256,0.2,Africa
Saint Kitts and Nevis,5941,43,0,5898,0,0,0,0.72,0.0,inf,5899,42,0.71,Americas
Saint Lucia,26911,380,0,26531,26,0,0,1.41,0.0,inf,26722,189,0.71,Americas
Saint Pierre and Miquelon (FR),2767,1,0,2766,0,0,0,0.04,0.0,inf,2767,0,0.0,Americas
Saint Vincent and the Grenadines,9026,111,0,8915,0,0,0,1.23,0.0,inf,8956,70,0.78,Americas
Samoa,14812,29,0,14783,0,0,0,0.2,0.0,inf,14497,315,2.17,Western Pacific
San Marino,17719,115,0,17604,0,0,0,0.65,0.0,inf,17413,306,1.76,Europe
Sao Tome and Principe,6023,73,0,5950,0,0,0,1.21,0.0,inf,6010,13,0.22,Africa
Saudi Arabia,788294,9194,0,779100,0,0,0,1.17,0.0,inf,783907,4387,0.56,Eastern Mediterranean
Senegal,86275,1968,0,84307,9,0,0,2.28,0.0,inf,86201,74,0.09,Africa
Serbia,2025577,16120,0,2009457,535,0,0,0.8,0.0,inf,2022252,3325,0.16,Europe
Seychelles,44669,167,0,44502,0,0,0,0.37,0.0,inf,44521,148,0.33,Africa
Sierra Leone,7693,125,0,7568,0,0,0,1.62,0.0,inf,7688,5,0.07,Africa
Singapore,1403242,1408,0,1401834,6168,0,0,0.1,0.0,inf,1364562,38680,2.83,Western Pacific
Sint Maarten (NL),10537,86,0,10451,0,0,0,0.82,0.0,inf,10508,29,0.28,Americas
Slovakia,2548586,20142,0,2528444,517,0,0,0.79,0.0,inf,2546134,2452,0.1,Europe
Slovenia,1034172,6648,0,1027524,0,0,0,0.64,0.0,inf,1030354,3818,0.37,Europe
Solomon Islands,21544,153,0,21391,0,0,0,0.71,0.0,inf,21544,0,0.0,Western Pacific
Somalia,26748,1361,0,25387,0,0,0,5.09,0.0,inf,26675,73,0.27,Eastern Mediterranean
South Africa,3991944,101727,0,3890217,941,10,0,2.55,0.0,inf,3984646,7298,0.18,Africa
South Korea,18326019,24522,0,18301497,6246,6,0,0.13,0.0,inf,18276552,49467,0.27,Western Pacific
South Sudan,17697,138,0,17559,0,0,0,0.78,0.0,inf,17697,0,0.0,Africa
Spain,12681820,107799,0,12574021,0,0,0,0.85,0.0,inf,12563399,118421,0.94,Europe
Sri Lanka,664065,16521,0,647544,13,0,0,2.49,0.0,inf,663984,81,0.01,South-East Asia
Sudan,62551,4951,0,57600,0,0,0,7.92,0.0,inf,62489,62,0.1,Eastern Mediterranean
Summer Olympics 2020,865,0,0,865,0,0,0,0.0,0.0,0.0,865,0,0.0,
Suriname,80817,1359,0,79458,0,0,0,1.68,0.0,inf,80766,51,0.06,Americas
Sweden,2515769,19093,0,2496676,0,0,0,0.76,0.0,inf,2512853,2916,0.12,Europe
Switzerland,3726615,13822,0,3712793,0,0,0,0.37,0.0,inf,3701895,24720,0.67,Europe
Syria,55920,3150,0,52770,0,0,0,5.63,0.0,inf,55913,7,0.01,Eastern Mediterranean
Taiwan*,3573703,6120,0,3567583,40368,151,0,0.17,0.0,inf,3244453,329250,10.15,Western Pacific
Tajikistan,17786,125,0,17661,0,0,0,0.7,0.0,inf,17786,0,0.0,Europe
Tanzania,35366,841,0,34525,0,0,0,2.38,0.0,inf,35354,12,0.03,Africa
Thailand,4514155,30592,0,4483563,4614,33,0,0.68,0.0,inf,4499044,15111,0.34,South-East Asia
Timor-Leste,22950,133,0,22817,1,0,0,0.58,0.0,inf,22944,6,0.03,South-East Asia
Togo,37328,275,0,37053,29,1,0,0.74,0.0,inf,37242,86,0.23,Africa
Tonga,12079,12,0,12067,0,0,0,0.1,0.0,inf,12079,0,0.0,Western Pacific
Trinidad and Tobago,166682,4000,0,162682,106,3,0,2.4,0.0,inf,165706,976,0.59,Americas
Tunisia,1046703,28670,0,1018033,0,0,0,2.74,0.0,inf,1044426,2277,0.22,Eastern Mediterranean
Turkey,15085742,98996,0,14986746,0,0,0,0.66,0.0,inf,15085742,0,0.0,Europe
Turks and Caicos Islands (UK),6211,36,0,6175,0,0,0,0.58,0.0,inf,6189,22,0.36,Americas
US,86949088,1015933,0,85933155,39372,144,0,1.17,0.0,inf,86230982,718106,0.83,Americas
Uganda,167367,3620,0,163747,66,2,0,2.16,0.0,inf,166809,558,0.33,Africa
Ukraine,5040518,112459,0,4928059,0,0,0,2.23,0.0,inf,5040518,0,0.0,Europe
United Arab Emirates,937037,2311,0,934726,1692,1,0,0.25,0.0,inf,925898,11139,1.2,Eastern Mediterranean
United Kingdom,22720938,180351,0,22540587,0,0,0,0.79,0.0,inf,22599349,121589,0.54,Europe
Uruguay,951948,7312,0,944636,0,0,0,0.77,0.0,inf,943877,8071,0.86,Americas
Uzbekistan,240206,1637,0,238569,119,0,0,0.68,0.0,inf,239525,681,0.28,Europe
Vanuatu,11044,14,0,11030,0,0,0,0.13,0.0,inf,10857,187,1.72,Western Pacific
Venezuela,525716,5728,0,519988,177,2,0,1.09,0.0,inf,524823,893,0.17,Americas
Vietnam,10742891,43084,0,10699807,657,0,0,0.4,0.0,inf,10737107,5784,0.05,Western Pacific
West Bank and Gaza,658503,5660,0,652843,0,0,0,0.86,0.0,inf,658100,403,0.06,Eastern Mediterranean
Winter Olympics 2022,535,0,0,535,0,0,0,0.0,0.0,0.0,535,0,0.0,
Yemen,11824,2149,0,9675,0,0,0,18.17,0.0,inf,11823,1,0.01,Eastern Mediterranean
Zambia,325110,4003,0,321107,0,0,0,1.23,0.0,inf,324025,1085,0.33,Africa
Zimbabwe,255309,5549,0,249760,0,0,0,2.17,0.0,inf,254753,556,0.22,Africa
