Country,Confirmed,Deaths,Recovered,Active,New cases,New deaths,New recovered,Deaths / 100 Cases,Recovered / 100 Cases,Deaths / 100 Recovered,Confirmed last week,1 week change,1 week % increase,WHO Region
Afghanistan,195631,7787,0,187844,160,1,0,3.98,0.0,inf,193912,1719,0.89,Eastern Mediterranean
Albania,330948,3584,0,327364,106,0,0,1.08,0.0,inf,330062,886,0.27,Europe
Algeria,270532,6879,0,263653,10,0,0,2.54,0.0,inf,270426,106,0.04,Africa
Andorra,46113,155,0,45958,0,0,0,0.34,0.0,inf,46027,86,0.19,Europe
Angola,103131,1917,0,101214,0,0,0,1.86,0.0,inf,102636,495,0.48,Africa
Anguilla (UK),3851,12,0,3839,0,0,0,0.31,0.0,inf,3837,14,0.36,Americas
Antarctica,11,0,0,11,0,0,0,0.0,0.0,0.0,11,0,0.0,
Antigua and Barbuda,8974,145,0,8829,0,0,0,1.62,0.0,inf,8974,0,0.0,Americas
Argentina,9689861,129769,0,9560092,0,0,0,1.34,0.0,inf,9678225,11636,0.12,Americas
Armenia,436727,8662,0,428065,0,0,0,1.98,0.0,inf,434398,2329,0.54,Europe
Aruba (NL),42970,228,0,42742,0,0,0,0.53,0.0,inf,42848,122,0.28,Americas
Australia,10114810,14426,0,10100384,3082,5,0,0.14,0.0,inf,10066729,48081,0.48,Western Pacific
Austria,4984809,20678,0,4964131,0,0,0,0.41,0.0,inf,4966009,18800,0.38,Europe
Azerbaijan,817596,9852,0,807744,274,3,0,1.2,0.0,inf,815047,2549,0.31,Europe
Bahamas,37125,823,0,36302,0,0,0,2.22,0.0,inf,37081,44,0.12,Americas
Bahrain,673693,1518,0,672175,195,0,0,0.23,0.0,inf,672245,1448,0.22,Eastern Mediterranean
Bangladesh,2014577,29332,0,1985245,222,1,0,1.46,0.0,inf,2012531,2046,0.1,South-East Asia
Barbados,101850,556,0,101294,41,0,0,0.55,0.0,inf,101397,453,0.45,Americas
Belarus,994037,7118,0,986919,0,0,0,0.72,0.0,inf,994037,0,0.0,Europe
Belgium,4497199,32575,0,4464624,0,0,0,0.72,0.0,inf,4488054,9145,0.2,Europe
Belize,68473,680,0,67793,0,0,0,0.99,0.0,inf,68350,123,0.18,Americas
Benin,27490,163,0,27327,0,0,0,0.59,0.0,inf,27490,0,0.0,Africa
Bhutan,61233,21,0,61212,0,0,0,0.03,0.0,inf,61076,157,0.26,South-East Asia
Bolivia,1105812,22216,0,1083596,269,2,0,2.01,0.0,inf,1103889,1923,0.17,Americas
Bosnia and Herzegovina,397098,16090,0,381008,0,0,0,4.05,0.0,inf,396273,825,0.21,Europe
Botswana,325931,2786,0,323145,0,0,0,0.85,0.0,inf,325864,67,0.02,Africa
Brazil,34516739,684813,0,33831926,0,0,0,1.98,0.0,inf,34456145,60594,0.18,Americas
British Virgin Islands (UK),7305,64,0,7241,0,0,0,0.88,0.0,inf,7291,14,0.19,Americas
Brunei,223059,225,0,222834,0,0,0,0.1,0.0,inf,220245,2814,1.28,Western Pacific
Bulgaria,1248035,37646,0,1210389,257,1,0,3.02,0.0,inf,1244555,3480,0.28,Europe
Burkina Faso,21128,387,0,20741,0,0,0,1.83,0.0,inf,21128,0,0.0,Africa
Burma,616663,19442,0,597221,262,0,0,3.15,0.0,inf,615489,1174,0.19,South-East Asia
Burundi,49370,38,0,49332,0,0,0,0.08,0.0,inf,49370,0,0.0,Africa
Cabo Verde,62341,410,0,61931,2,0,0,0.66,0.0,inf,62326,15,0.02,Africa
Cambodia,137705,3056,0,134649,9,0,0,2.22,0.0,inf,137650,55,0.04,Western Pacific
Cameroon,121652,1935,0,119717,0,0,0,1.59,0.0,inf,121652,0,0.0,Africa
Canada,4225383,44606,0,4180777,637,8,0,1.06,0.0,inf,4208609,16774,0.4,Americas
Cayman Islands (UK),30214,29,0,30185,0,0,0,0.1,0.0,inf,30057,157,0.52,Americas
Central African Republic,14883,113,0,14770,0,0,0,0.76,0.0,inf,14862,21,0.14,Africa
Chad,7549,193,0,7356,0,0,0,2.56,0.0,inf,7538,11,0.15,Africa
Chile,4559801,60749,0,4499052,4548,28,0,1.33,0.0,inf,4527533,32268,0.71,Americas
China,2615637,15020,0,2600617,10021,8,0,0.57,0.0,inf,2533531,82106,3.24,Western Pacific
Colombia,6304317,141708,0,6162609,0,0,0,2.25,0.0,inf,6302809,1508,0.02,Americas
Comoros,8455,161,0,8294,0,0,0,1.9,0.0,inf,8455,0,0.0,Africa
Congo (Brazzaville),24837,386,0,24451,0,0,0,1.55,0.0,inf,24837,0,0.0,Africa
Congo (Kinshasa),92751,1422,0,91329,0,0,0,1.53,0.0,inf,92711,40,0.04,Africa
Costa Rica,1097629,8893,0,1088736,0,6,0,0.81,0.0,inf,1088716,8913,0.82,Americas
Cote d'Ivoire,86919,822,0,86097,34,1,0,0.95,0.0,inf,86808,111,0.13,Africa
Croatia,1220015,16792,0,1203223,1352,20,0,1.38,0.0,inf,1215999,4016,0.33,Europe
Cuba,1110858,8530,0,1102328,18,0,0,0.77,0.0,inf,1110668,190,0.02,Americas
Curacao (NL),45318,287,0,45031,0,0,0,0.63,0.0,inf,45302,16,0.04,Americas
Cyprus,579899,1173,0,578726,1869,1,0,0.2,0.0,inf,578030,1869,0.32,Europe
Czechia,4059173,40906,0,4018267,459,1,0,1.01,0.0,inf,4046577,12596,0.31,Europe
Denmark,3280052,6968,0,3273084,0,0,0,0.21,0.0,inf,3274583,5469,0.17,Europe
Djibouti,15690,189,0,15501,0,0,0,1.2,0.0,inf,15690,0,0.0,Eastern Mediterranean
Dominica,14852,68,0,14784,0,0,0,0.46,0.0,inf,14852,0,0.0,Americas
Dominican Republic,641677,4384,0,637293,1613,0,0,0.68,0.0,inf,638500,3177,0.5,Americas
Ecuador,998202,35876,0,962326,0,0,0,3.59,0.0,inf,997224,978,0.1,Americas
Egypt,515645,24796,0,490849,0,0,0,4.81,0.0,inf,515645,0,0.0,Eastern Mediterranean
El Salvador,201785,4227,0,197558,0,0,0,2.09,0.0,inf,201785,0,0.0,Americas
Equatorial Guinea,16965,183,0,16782,0,0,0,1.08,0.0,inf,16957,8,0.05,Africa
Eritrea,10163,103,0,10060,0,0,0,1.01,0.0,inf,10155,8,0.08,Africa
Estonia,598636,2657,0,595979,0,0,0,0.44,0.0,inf,597838,798,0.13,Europe
Eswatini,73368,1422,0,71946,0,0,0,1.94,0.0,inf,73368,0,0.0,Africa
Ethiopia,493340,7572,0,485768,7,0,0,1.53,0.0,inf,493234,106,0.02,Africa
Falkland Islands (Malvinas) (UK),1886,0,0,1886,0,0,0,0.0,0.0,0.0,1886,0,0.0,Africa
Faroe Islands (DK),34658,28,0,34630,0,0,0,0.08,0.0,inf,34658,0,0.0,Europe
Fiji,68207,878,0,67329,0,0,0,1.29,0.0,inf,68177,30,0.04,Western Pacific
Finland,1271516,5768,0,1265748,0,0,0,0.45,0.0,inf,1266917,4599,0.36,Europe
France,33810459,151381,0,33659078,0,0,0,0.45,0.0,inf,33692489,117970,0.35,Europe
French Guiana,93735,408,0,93327,0,0,0,0.44,0.0,inf,93735,0,0.0,Americas
French Polynesia,76520,649,0,75871,0,0,0,0.85,0.0,inf,76484,36,0.05,Western Pacific
Gabon,48668,306,0,48362,0,0,0,0.63,0.0,inf,48649,19,0.04,Africa
Gambia,12311,371,0,11940,0,0,0,3.01,0.0,inf,12311,0,0.0,Africa
Georgia,1735682,16889,0,1718793,0,0,0,0.97,0.0,inf,1735682,0,0.0,Europe
Germany,32452250,148299,0,32303951,0,0,0,0.46,0.0,inf,32247828,204422,0.63,Europe
Ghana,168616,1459,0,167157,36,0,0,0.87,0.0,inf,168580,36,0.02,Africa
Gibraltar (UK),20069,108,0,19961,0,0,0,0.54,0.0,inf,20069,0,0.0,Europe
Greece,4804982,32757,0,4772225,0,0,0,0.68,0.0,inf,4762827,42155,0.89,Europe
Greenland (DK),11971,21,0,11950,0,0,0,0.18,0.0,inf,11971,0,0.0,Europe
Grenada,19403,236,0,19167,0,0,0,1.22,0.0,inf,19346,57,0.29,Americas
Guadeloupe (FR),191997,986,0,191011,0,0,0,0.51,0.0,inf,191997,0,0.0,Americas
Guatemala,1110973,19650,0,1091323,1033,6,0,1.77,0.0,inf,1104842,6131,0.55,Americas
Guinea,37652,449,0,37203,0,0,0,1.19,0.0,inf,37470,182,0.49,Africa
Guinea-Bissau,8796,175,0,8621,0,0,0,1.99,0.0,inf,8796,0,0.0,Africa
Guyana,71186,1279,0,69907,12,0,0,1.8,0.0,inf,71085,101,0.14,Americas
Haiti,33658,851,0,32807,0,0,0,2.53,0.0,inf,33468,190,0.57,Americas
Holy See,29,0,0,29,0,0,0,0.0,0.0,0.0,29,0,0.0,Europe
Honduras,455011,10989,0,444022,0,0,0,2.42,0.0,inf,454779,232,0.05,Americas
Hungary,2058847,47367,0,2011480,0,0,0,2.3,0.0,inf,2048547,10300,0.5,Europe
Iceland,205009,213,0,204796,0,0,0,0.1,0.0,inf,204717,292,0.14,Europe
India,44495359,528150,0,43967209,5076,11,0,1.19,0.0,inf,44456535,38824,0.09,South-East Asia
Indonesia,6390553,157757,0,6232796,2609,16,0,2.47,0.0,inf,6369778,20775,0.33,South-East Asia
Iran,7538125,144154,0,7393971,344,19,0,1.91,0.0,inf,7531924,6201,0.08,Eastern Mediterranean
Iraq,2458509,25348,0,2433161,0,0,0,1.03,0.0,inf,2457871,638,0.03,Eastern Mediterranean
Ireland,1659034,7870,0,1651164,0,0,0,0.47,0.0,inf,1656956,2078,0.13,Europe
Israel,4641834,11648,0,4630186,1623,0,0,0.25,0.0,inf,4635142,6692,0.14,Europe
Italy,22035291,176204,0,21859087,15137,47,0,0.8,0.0,inf,21925073,110218,0.5,Europe
Jamaica,150663,3283,0,147380,73,6,0,2.18,0.0,inf,150101,562,0.37,Americas
Japan,20074857,42554,0,20032303,92699,208,0,0.21,0.0,inf,19352819,722038,3.73,Western Pacific
Jordan,1738867,14114,0,1724753,0,0,0,0.81,0.0,inf,1735495,3372,0.19,Eastern Mediterranean
Kazakhstan,1481339,19043,0,1462296,217,0,0,1.29,0.0,inf,1479475,1864,0.13,Europe
Kenya,338290,5674,0,332616,10,0,0,1.68,0.0,inf,338234,56,0.02,Africa
Kiribati,3430,13,0,3417,0,0,0,0.38,0.0,inf,3430,0,0.0,Western Pacific
"Korea, North",1,6,0,-5,0,0,0,600.0,0.0,inf,1,0,0.0,
Kosovo,271922,3199,0,268723,25,0,0,1.18,0.0,inf,271680,242,0.09,Europe
Kuwait,657745,2563,0,655182,0,0,0,0.39,0.0,inf,657395,350,0.05,Eastern Mediterranean
Kyrgyzstan,205835,2991,0,202844,0,0,0,1.45,0.0,inf,205716,119,0.06,Europe
Laos,214897,757,0,214140,0,0,0,0.35,0.0,inf,214407,490,0.23,Western Pacific
Latvia,905904,5957,0,899947,0,0,0,0.66,0.0,inf,900654,5250,0.58,Europe
Lebanon,1212497,10645,0,1201852,239,1,0,0.88,0.0,inf,1210566,1931,0.16,Eastern Mediterranean
Lesotho,34287,704,0,33583,0,0,0,2.05,0.0,inf,34206,81,0.24,Africa
Liberia,7898,294,0,7604,0,0,0,3.72,0.0,inf,7883,15,0.19,Africa
Libya,506889,6437,0,500452,0,0,0,1.27,0.0,inf,506838,51,0.01,Eastern Mediterranean
Liechtenstein,19285,86,0,19199,0,0,0,0.45,0.0,inf,19183,102,0.53,Europe
Lithuania,1226496,9294,0,1217202,1018,0,0,0.76,0.0,inf,1220758,5738,0.47,Europe
Luxembourg,288658,1123,0,287535,0,0,0,0.39,0.0,inf,288658,0,0.0,Europe
Madagascar,66640,1410,0,65230,0,0,0,2.12,0.0,inf,66626,14,0.02,Africa
Malawi,87933,2679,0,85254,0,0,0,3.05,0.0,inf,87894,39,0.04,Africa
Malaysia,4803624,36277,0,4767347,1971,3,0,0.76,0.0,inf,4789552,14072,0.29,Western Pacific
Maldives,184924,308,0,184616,0,0,0,0.17,0.0,inf,184856,68,0.04,South-East Asia
Mali,32205,739,0,31466,88,0,0,2.29,0.0,inf,31576,629,1.99,Africa
Malta,114251,802,0,113449,23,0,0,0.7,0.0,inf,114114,137,0.12,Europe
Marshall Islands,15072,17,0,15055,0,0,0,0.11,0.0,inf,15063,9,0.06,Western Pacific
Martinique (FR),215582,1022,0,214560,0,0,0,0.47,0.0,inf,215582,0,0.0,Americas
Mauritania,62776,993,0,61783,1,0,0,1.58,0.0,inf,62770,6,0.01,Africa
Mauritius,258301,1023,0,257278,0,0,0,0.4,0.0,inf,256452,1849,0.72,Africa
Mayotte (FR),40095,187,0,39908,0,0,0,0.47,0.0,inf,40095,0,0.0,Africa
Mexico,7056269,329736,0,6726533,10049,84,0,4.67,0.0,inf,7036371,19898,0.28,Americas
Micronesia,9037,27,0,9010,0,0,0,0.3,0.0,inf,7856,1181,15.03,Western Pacific
Moldova,579110,11783,0,567327,0,0,0,2.03,0.0,inf,575052,4058,0.71,Europe
Monaco,14436,63,0,14373,0,0,0,0.44,0.0,inf,14404,32,0.22,Europe
Mongolia,980442,2129,0,978313,0,0,0,0.22,0.0,inf,979985,457,0.05,Western Pacific
Montenegro,277191,2778,0,274413,130,0,0,1.0,0.0,inf,276179,1012,0.37,Europe
Montserrat (UK),1276,8,0,1268,47,0,0,0.63,0.0,inf,1190,86,7.23,Americas
Morocco,1264648,16276,0,1248372,26,1,0,1.29,0.0,inf,1264531,117,0.01,Eastern Mediterranean
Mozambique,230171,2221,0,227950,14,0,0,0.96,0.0,inf,230113,58,0.03,Africa
Namibia,169253,4077,0,165176,0,0,0,2.41,0.0,inf,169253,0,0.0,Africa
Nepal,998654,12012,0,986642,112,0,0,1.2,0.0,inf,997752,902,0.09,South-East Asia
Netherlands,8396858,22613,0,8374245,0,0,0,0.27,0.0,inf,8389695,7163,0.09,Europe
New Zealand,1765270,1951,0,1763319,971,0,0,0.11,0.0,inf,1754112,11158,0.64,Western Pacific
Nicaragua,14931,244,0,14687,0,0,0,1.63,0.0,inf,14931,0,0.0,Americas
Niger,9931,312,0,9619,0,0,0,3.14,0.0,inf,9931,0,0.0,Africa
Nigeria,264299,3154,0,261145,0,0,0,1.19,0.0,inf,263867,432,0.16,Africa
North Macedonia,341404,9506,0,331898,0,0,0,2.78,0.0,inf,340695,709,0.21,Europe
Norway,1460970,4004,0,1456966,40,0,0,0.27,0.0,inf,1460405,565,0.04,Europe
Oman,397993,4628,0,393365,0,0,0,1.16,0.0,inf,397846,147,0.04,Eastern Mediterranean
Pakistan,1571091,30599,0,1540492,295,1,0,1.95,0.0,inf,1569076,2015,0.13,Eastern Mediterranean
Palau,5430,6,0,5424,0,0,0,0.11,0.0,inf,5403,27,0.5,Western Pacific
Panama,981822,8480,0,973342,0,0,0,0.86,0.0,inf,978181,3641,0.37,Americas
Papua New Guinea,44900,664,0,44236,0,0,0,1.48,0.0,inf,44887,13,0.03,Western Pacific
Paraguay,715806,19530,0,696276,0,0,0,2.73,0.0,inf,715569,237,0.03,Americas
Peru,4125208,216086,0,3909122,1773,41,0,5.24,0.0,inf,4113567,11641,0.28,Americas
Philippines,3904133,62288,0,3841845,3100,39,0,1.6,0.0,inf,3889160,14973,0.38,Western Pacific
Poland,6211955,117252,0,6094703,4970,19,0,1.89,0.0,inf,6186948,25007,0.4,Europe
Portugal,5440953,24909,0,5416044,0,0,0,0.46,0.0,inf,5425891,15062,0.28,Europe
Qatar,435192,682,0,434510,478,0,0,0.16,0.0,inf,430945,4247,0.99,Eastern Mediterranean
Reunion (FR),467390,874,0,466516,0,0,0,0.19,0.0,inf,467390,0,0.0,Africa
Romania,3239392,66849,0,3172543,1802,11,0,2.06,0.0,inf,3226207,13185,0.41,Europe
Russia,19722556,377462,0,19345094,52708,94,0,1.91,0.0,inf,19394864,327692,1.69,Europe
Rwanda,132472,1466,0,131006,0,0,0,1.11,0.0,inf,132449,23,0.02,Africa
Saint Kitts and Nevis,6524,46,0,6478,0,0,0,0.71,0.0,inf,6517,7,0.11,Americas
Saint Lucia,28894,391,0,28503,0,0,0,1.35,0.0,inf,28894,0,0.0,Americas
Saint Pierre and Miquelon (FR),3131,1,0,3130,0,0,0,0.03,0.0,inf,3131,0,0.0,Americas
Saint Vincent and the Grenadines,9430,115,0,9315,0,0,0,1.22,0.0,inf,9430,0,0.0,Americas
Samoa,15889,29,0,15860,50,0,0,0.18,0.0,inf,15839,50,0.32,Western Pacific
San Marino,20486,118,0,20368,0,0,0,0.58,0.0,inf,20398,88,0.43,Europe
Sao Tome and Principe,6177,76,0,6101,0,0,0,1.23,0.0,inf,6153,24,0.39,Africa
Saudi Arabia,814356,9315,0,805041,78,2,0,1.14,0.0,inf,813682,674,0.08,Eastern Mediterranean
Senegal,88172,1968,0,86204,0,0,0,2.23,0.0,inf,88102,70,0.08,Africa
Serbia,2313346,16809,0,2296537,2745,15,0,0.73,0.0,inf,2292170,21176,0.92,Europe
Seychelles,46175,169,0,46006,0,0,0,0.37,0.0,inf,46081,94,0.2,Africa
Sierra Leone,7749,126,0,7623,0,0,0,1.63,0.0,inf,7747,2,0.03,Africa
Singapore,1858497,1602,0,1856895,1824,0,0,0.09,0.0,inf,1844785,13712,0.74,Western Pacific
Sint Maarten (NL),10847,87,0,10760,0,0,0,0.8,0.0,inf,10836,11,0.1,Americas
Slovakia,2580748,20236,0,2560512,0,0,0,0.78,0.0,inf,2580748,0,0.0,Europe
Slovenia,1142042,6792,0,1135250,2055,1,0,0.59,0.0,inf,1130856,11186,0.99,Europe
Solomon Islands,21544,153,0,21391,0,0,0,0.71,0.0,inf,21544,0,0.0,Western Pacific
Somalia,27020,1361,0,25659,0,0,0,5.04,0.0,inf,27020,0,0.0,Eastern Mediterranean
South Africa,4014277,102129,0,3912148,227,0,0,2.54,0.0,inf,4012653,1624,0.04,Africa
South Korea,24004887,27476,0,23977411,28214,47,0,0.11,0.0,inf,23569192,435695,1.85,Western Pacific
South Sudan,17823,138,0,17685,0,0,0,0.77,0.0,inf,17823,0,0.0,Africa
Spain,13367647,113130,0,13254517,0,0,0,0.85,0.0,inf,13352019,15628,0.12,Europe
Sri Lanka,670408,16727,0,653681,32,2,0,2.5,0.0,inf,670127,281,0.04,South-East Asia
Sudan,63270,4961,0,58309,0,0,0,7.84,0.0,inf,63228,42,0.07,Eastern Mediterranean
Summer Olympics 2020,865,0,0,865,0,0,0,0.0,0.0,0.0,865,0,0.0,
Suriname,81057,1384,0,79673,0,0,0,1.71,0.0,inf,81039,18,0.02,Americas
Sweden,2573548,20006,0,2553542,0,0,0,0.78,0.0,inf,2569152,4396,0.17,Europe
Switzerland,4059532,13987,0,4045545,0,0,0,0.34,0.0,inf,4045011,14521,0.36,Europe
Syria,57144,3163,0,53981,0,0,0,5.54,0.0,inf,57069,75,0.13,Eastern Mediterranean
Taiwan*,5650028,10255,0,5639773,35801,30,0,0.18,0.0,inf,5408641,241387,4.46,Western Pacific
Tajikistan,17786,125,0,17661,0,0,0,0.7,0.0,inf,17786,0,0.0,Europe
Tanzania,39168,845,0,38323,0,0,0,2.16,0.0,inf,38712,456,1.18,Africa
Thailand,4667546,32539,0,4635007,1093,19,0,0.7,0.0,inf,4658542,9004,0.19,South-East Asia
Timor-Leste,23217,138,0,23079,13,0,0,0.59,0.0,inf,23179,38,0.16,South-East Asia
Togo,38614,284,0,38330,24,0,0,0.74,0.0,inf,38530,84,0.22,Africa
Tonga,16182,12,0,16170,0,0,0,0.07,0.0,inf,15805,377,2.39,Western Pacific
Trinidad and Tobago,181206,4168,0,177038,234,2,0,2.3,0.0,inf,179683,1523,0.85,Americas
Tunisia,1144824,29238,0,1115586,0,0,0,2.55,0.0,inf,1143862,962,0.08,Eastern Mediterranean
Turkey,16797750,100840,0,16696910,0,0,0,0.6,0.0,inf,16751868,45882,0.27,Europe
Turks and Caicos Islands (UK),6372,36,0,6336,0,0,0,0.56,0.0,inf,6369,3,0.05,Americas
US,95242750,1050318,0,94192432,17949,28,0,1.1,0.0,inf,94737334,505416,0.53,Americas
Uganda,169396,3628,0,165768,0,0,0,2.14,0.0,inf,169396,0,0.0,Africa
Ukraine,5363758,116685,0,5247073,778,3,0,2.18,0.0,inf,5342895,20863,0.39,Europe
United Arab Emirates,1019625,2342,0,1017283,412,0,0,0.23,0.0,inf,1016745,2880,0.28,Eastern Mediterranean
United Kingdom,23700592,206180,0,23494412,0,0,0,0.87,0.0,inf,23667370,33222,0.14,Europe
Uruguay,981186,7455,0,973731,0,0,0,0.76,0.0,inf,979160,2026,0.21,Americas
Uzbekistan,243893,1637,0,242256,0,0,0,0.67,0.0,inf,243830,63,0.03,Europe
Vanuatu,11908,14,0,11894,0,0,0,0.12,0.0,inf,11836,72,0.61,Western Pacific
Venezuela,543759,5807,0,537952,555,3,0,1.07,0.0,inf,542874,885,0.16,Americas
Vietnam,11437970,43126,0,11394844,2498,0,0,0.38,0.0,inf,11417503,20467,0.18,Western Pacific
West Bank and Gaza,702591,5706,0,696885,0,0,0,0.81,0.0,inf,702332,259,0.04,Eastern Mediterranean
Winter Olympics 2022,535,0,0,535,0,0,0,0.0,0.0,0.0,535,0,0.0,
Yemen,11932,2155,0,9777,0,0,0,18.06,0.0,inf,11926,6,0.05,Eastern Mediterranean
Zambia,333220,4017,0,329203,16,0,0,1.21,0.0,inf,332822,398,0.12,Africa
Zimbabwe,256870,5596,0,251274,11,0,0,2.18,0.0,inf,256755,115,0.04,Africa
